Player,Innings Fielded,Fielding Dismissals Made,Catches Taken,Stumpings Made,Catches As A Keeper,Catches As A Fielder,Max Dismissals In An Innings,Dismissals Per Innings
AJ Stewart (1989-2003),169,174,159,15,148,11,6 (6ct 0st),1.029
JC Buttler (2012-2018),108,160,141,19,141,0,6 (6ct 0st),1.481
PD Collingwood (2001-2011),197,108,108,0,0,108,3 (3ct 0st),0.548
MJ Prior (2004-2011),68,79,71,8,69,2,6 (6ct 0st),1.161
GO Jones (2004-2006),49,72,68,4,68,0,5 (5ct 0st),1.469
EJG Morgan (2009-2018),176,66,66,0,3,63,3 (3ct 0st),0.375
C Kieswetter (2010-2013),45,65,53,12,52,1,5 (2ct 3st),1.444
GA Hick (1991-2001),119,64,64,0,0,64,3 (3ct 0st),0.537
AJ Strauss (2003-2011),127,57,57,0,0,57,3 (3ct 0st),0.448
IR Bell (2004-2015),160,54,54,0,0,54,3 (3ct 0st),0.337
JM Anderson (2002-2015),192,53,53,0,0,53,3 (3ct 0st),0.276
JE Root (2013-2018),107,53,53,0,0,53,2 (2ct 0st),0.495
ME Trescothick (2000-2006),121,49,49,0,4,45,3 (3ct 0st),0.404
RC Russell (1987-1998),40,47,41,6,41,0,3 (3ct 0st),1.175
A Flintoff (1999-2009),137,46,46,0,0,46,3 (3ct 0st),0.335
GA Gooch (1976-1995),125,45,45,0,0,45,2 (2ct 0st),0.360
DI Gower (1978-1991),114,44,44,0,0,44,3 (3ct 0st),0.385
NV Knight (1996-2003),100,44,44,0,0,44,2 (2ct 0st),0.440
CMW Read (2000-2006),35,43,41,2,41,0,5 (5ct 0st),1.228
GP Thorpe (1993-2002),81,42,42,0,0,42,3 (3ct 0st),0.518
N Hussain (1989-2003),88,40,40,0,0,40,2 (2ct 0st),0.454
KP Pietersen (2004-2013),133,39,39,0,0,39,2 (2ct 0st),0.293
IT Botham (1976-1992),116,36,36,0,0,36,2 (2ct 0st),0.310
AN Cook (2006-2014),91,36,36,0,0,36,2 (2ct 0st),0.395
RS Bopara (2007-2015),118,35,35,0,0,35,2 (2ct 0st),0.296
BA Stokes (2011-2018),65,34,34,0,0,34,3 (3ct 0st),0.523
NH Fairbrother (1987-1999),75,33,33,0,0,33,3 (3ct 0st),0.440
RW Taylor (1973-1984),27,32,26,6,26,0,4 (4ct 0st),1.185
CR Woakes (2011-2018),74,32,32,0,0,32,3 (3ct 0st),0.432
AJ Lamb (1982-1992),122,31,31,0,0,31,2 (2ct 0st),0.254
PR Downton (1977-1988),28,29,26,3,26,0,4 (4ct 0st),1.035
GP Swann (2000-2013),78,29,29,0,0,29,3 (3ct 0st),0.371
SCJ Broad (2006-2016),121,27,27,0,0,27,2 (2ct 0st),0.223
PAJ DeFreitas (1987-1997),103,26,26,0,0,26,2 (2ct 0st),0.252
RA Smith (1988-1996),71,26,26,0,0,26,2 (2ct 0st),0.366
DW Randall (1976-1985),49,25,25,0,0,25,2 (2ct 0st),0.510
MP Vaughan (2001-2007),85,25,25,0,0,25,3 (3ct 0st),0.294
MM Ali (2014-2018),74,24,24,0,0,24,3 (3ct 0st),0.324
JM Bairstow (2011-2018),43,24,22,2,8,14,3 (2ct 1st),0.558
D Gough (1994-2006),156,24,24,0,0,24,1 (1ct 0st),0.153
PA Nixon (2007-2007),19,23,20,3,20,0,2 (2ct 0st),1.210
MW Gatting (1977-1993),92,22,22,0,0,22,2 (2ct 0st),0.239
AF Giles (1997-2005),62,22,22,0,0,22,3 (3ct 0st),0.354
AD Hales (2014-2018),60,22,22,0,0,22,2 (2ct 0st),0.366
LE Plunkett (2005-2018),66,22,22,0,0,22,2 (2ct 0st),0.333
RGD Willis (1973-1984),64,22,22,0,0,22,2 (2ct 0st),0.343
DL Bairstow (1979-1984),21,21,17,4,17,0,3 (3ct 0st),1.000
JJ Roy (2015-2018),59,21,21,0,0,21,2 (2ct 0st),0.355
OA Shah (2001-2009),71,21,21,0,0,21,2 (2ct 0st),0.295
TT Bresnan (2006-2015),84,20,20,0,0,20,2 (2ct 0st),0.238
JS Foster (2001-2002),11,20,13,7,13,0,3 (2ct 1st),1.818
CC Lewis (1990-1998),53,20,20,0,0,20,2 (2ct 0st),0.377
AU Rashid (2009-2018),65,20,20,0,0,20,3 (3ct 0st),0.307
JE Emburey (1980-1993),61,19,19,0,0,19,2 (2ct 0st),0.311
CJ Jordan (2013-2016),31,19,19,0,0,19,2 (2ct 0st),0.612
IJ Gould (1983-1983),18,18,15,3,15,0,3 (3ct 0st),1.000
LJ Wright (2007-2014),50,18,18,0,0,18,2 (2ct 0st),0.360
CJ Richards (1981-1988),22,17,16,1,16,0,3 (3ct 0st),0.772
DJ Willey (2015-2018),35,17,17,0,0,17,2 (2ct 0st),0.485
CWJ Athey (1980-1988),31,16,16,0,0,16,3 (3ct 0st),0.516
BN French (1985-1988),13,16,13,3,13,0,3 (3ct 0st),1.230
APE Knott (1971-1977),19,16,15,1,15,0,4 (4ct 0st),0.842
VS Solanki (2000-2006),50,16,16,0,0,16,2 (2ct 0st),0.320
MA Atherton (1990-1998),54,15,15,0,0,15,2 (2ct 0st),0.277
ST Finn (2011-2017),67,15,15,0,0,15,2 (2ct 0st),0.223
JC Tredwell (2010-2015),44,14,14,0,0,14,2 (2ct 0st),0.318
IJL Trott (2009-2013),66,14,14,0,0,14,2 (2ct 0st),0.212
AJ Hollioake (1996-1999),35,13,13,0,0,13,3 (3ct 0st),0.371
SW Billings (2015-2018),14,12,12,0,4,8,2 (2ct 0st),0.857
JM Brearley (1977-1980),25,12,12,0,0,12,2 (2ct 0st),0.480
JWM Dalrymple (2006-2007),27,12,12,0,0,12,2 (2ct 0st),0.444
NA Foster (1984-1989),48,12,12,0,0,12,2 (2ct 0st),0.250
DA Reeve (1991-1996),29,12,12,0,0,12,3 (3ct 0st),0.413
C White (1994-2003),50,12,12,0,0,12,1 (1ct 0st),0.240
R Clarke (2003-2006),20,11,11,0,0,11,3 (3ct 0st),0.550
RDB Croft (1996-2001),49,11,11,0,0,11,1 (1ct 0st),0.224
P Mustard (2007-2008),10,11,9,2,9,0,2 (2ct 0st),1.100
DR Pringle (1982-1993),44,11,11,0,0,11,2 (2ct 0st),0.250
SJ Rhodes (1989-1995),9,11,9,2,9,0,4 (3ct 1st),1.222
BC Broad (1987-1988),34,10,10,0,0,10,1 (1ct 0st),0.294
SJ Harmison (2002-2009),58,10,10,0,0,10,1 (1ct 0st),0.172
MH Yardy (2006-2011),28,10,10,0,0,10,2 (2ct 0st),0.357
AR Caddick (1993-2003),53,9,9,0,0,9,2 (2ct 0st),0.169
MA Ealham (1996-2001),63,9,9,0,0,9,1 (1ct 0st),0.142
GS Ballance (2013-2015),16,8,8,0,0,8,2 (2ct 0st),0.500
ID Blackwell (2002-2006),34,8,8,0,0,8,2 (2ct 0st),0.235
SM Davies (2009-2011),8,8,8,0,8,0,2 (2ct 0st),1.000
RK Illingworth (1991-1996),25,8,8,0,0,8,2 (2ct 0st),0.320
W Larkins (1979-1991),25,8,8,0,0,8,1 (1ct 0st),0.320
VJ Marks (1980-1988),34,8,8,0,0,8,1 (1ct 0st),0.235
AD Mullally (1996-2001),49,8,8,0,0,8,2 (2ct 0st),0.163
CM Old (1973-1981),32,8,8,0,0,8,2 (2ct 0st),0.250
MR Ramprakash (1991-2001),18,8,8,0,0,8,2 (2ct 0st),0.444
MA Wood (2015-2018),28,8,8,0,0,8,2 (2ct 0st),0.285
AW Greig (1972-1977),21,7,7,0,0,7,3 (3ct 0st),0.333
SR Patel (2008-2013),36,7,7,0,0,7,2 (2ct 0st),0.194
GC Small (1987-1992),53,7,7,0,0,7,2 (2ct 0st),0.132
CJ Tavare (1980-1984),29,7,7,0,0,7,2 (2ct 0st),0.241
JWA Taylor (2011-2015),27,7,7,0,0,7,3 (3ct 0st),0.259
VJ Wells (1999-1999),9,7,7,0,0,7,3 (3ct 0st),0.777
AD Brown (1996-2001),16,6,6,0,0,6,2 (2ct 0st),0.375
DJ Capel (1987-1990),23,6,6,0,0,6,2 (2ct 0st),0.260
DG Cork (1992-2002),32,6,6,0,0,6,2 (2ct 0st),0.187
PH Edmonds (1977-1987),29,6,6,0,0,6,2 (2ct 0st),0.206
G Fowler (1983-1986),26,6,4,2,2,2,3 (1ct 2st),0.230
BC Hollioake (1997-2002),20,6,6,0,0,6,1 (1ct 0st),0.300
RC Irani (1996-2003),31,6,6,0,0,6,1 (1ct 0st),0.193
EC Joyce (2006-2007),17,6,6,0,0,6,2 (2ct 0st),0.352
JK Lever (1976-1982),22,6,6,0,0,6,2 (2ct 0st),0.272
RT Robinson (1984-1988),26,6,6,0,0,6,2 (2ct 0st),0.230
RJ Sidebottom (2001-2010),25,6,6,0,0,6,1 (1ct 0st),0.240
DL Underwood (1973-1982),26,6,6,0,0,6,2 (2ct 0st),0.230
B Wood (1972-1982),13,6,6,0,0,6,2 (2ct 0st),0.461
G Boycott (1971-1981),35,5,5,0,0,5,3 (3ct 0st),0.142
NG Cowans (1983-1985),23,5,5,0,0,5,1 (1ct 0st),0.217
JL Denly (2009-2009),9,5,5,0,0,5,2 (2ct 0st),0.555
JW Dernbach (2011-2013),24,5,5,0,0,5,2 (2ct 0st),0.208
ARC Fraser (1989-1999),42,5,5,0,0,5,1 (1ct 0st),0.119
EE Hemmings (1982-1991),33,5,5,0,0,5,1 (1ct 0st),0.151
M Hendrick (1973-1981),22,5,5,0,0,5,1 (1ct 0st),0.227
MJ Hoggard (2001-2006),26,5,5,0,0,5,1 (1ct 0st),0.192
TE Jesty (1983-1983),10,5,5,0,0,5,2 (2ct 0st),0.500
RJ Kirtley (2001-2004),11,5,5,0,0,5,1 (1ct 0st),0.454
MD Moxon (1985-1988),8,5,5,0,0,5,2 (2ct 0st),0.625
JN Snape (2001-2002),10,5,5,0,0,5,2 (2ct 0st),0.500
JT Ball (2016-2018),17,4,4,0,0,4,3 (3ct 0st),0.235
GD Barlow (1976-1977),6,4,4,0,0,4,2 (2ct 0st),0.666
GJ Batty (2002-2009),10,4,4,0,0,4,2 (2ct 0st),0.400
TK Curran (2017-2018),8,4,4,0,0,4,1 (1ct 0st),0.500
GR Dilley (1979-1988),36,4,4,0,0,4,2 (2ct 0st),0.111
KWR Fletcher (1971-1982),23,4,4,0,0,4,1 (1ct 0st),0.173
RD Jackman (1974-1983),15,4,4,0,0,4,1 (1ct 0st),0.266
A McGrath (2003-2004),13,4,4,0,0,4,2 (2ct 0st),0.307
AD Mascarenhas (2007-2009),20,4,4,0,0,4,2 (2ct 0st),0.200
MP Maynard (1994-2000),13,4,4,0,0,4,1 (1ct 0st),0.307
G Miller (1977-1984),25,4,4,0,0,4,2 (2ct 0st),0.160
A Shahzad (2010-2011),11,4,4,0,0,4,2 (2ct 0st),0.363
CT Tremlett (2005-2011),15,4,4,0,0,4,1 (1ct 0st),0.266
PCR Tufnell (1990-1997),20,4,4,0,0,4,2 (2ct 0st),0.200
JM Vince (2015-2016),5,4,4,0,0,4,2 (2ct 0st),0.800
P Willey (1977-1986),26,4,4,0,0,4,1 (1ct 0st),0.153
CJ Adams (1998-2000),5,3,3,0,0,3,1 (1ct 0st),0.600
MW Alleyne (1999-2000),10,3,3,0,0,3,1 (1ct 0st),0.300
TR Ambrose (2008-2008),5,3,3,0,3,0,1 (1ct 0st),0.600
RJ Blakey (1992-1993),3,3,2,1,2,0,2 (1ct 1st),1.000
DW Headley (1996-1999),13,3,3,0,0,3,1 (1ct 0st),0.230
D Lloyd (1973-1980),8,3,3,0,0,3,1 (1ct 0st),0.375
MS Panesar (2007-2007),26,3,3,0,0,3,1 (1ct 0st),0.115
RA Woolmer (1972-1976),6,3,3,0,0,3,1 (1ct 0st),0.500
PJW Allott (1982-1985),13,2,2,0,0,2,1 (1ct 0st),0.153
DL Amiss (1972-1977),17,2,2,0,0,2,1 (1ct 0st),0.117
GG Arnold (1972-1975),13,2,2,0,0,2,1 (1ct 0st),0.153
MP Bicknell (1990-1991),7,2,2,0,0,2,1 (1ct 0st),0.285
MA Carberry (2013-2014),5,2,2,0,0,2,1 (1ct 0st),0.400
G Cook (1981-1983),6,2,2,0,0,2,1 (1ct 0st),0.333
NGB Cook (1984-1989),3,2,2,0,0,2,1 (1ct 0st),0.666
JP Crawley (1994-1999),13,2,1,1,0,1,1 (1ct 0st),0.153
RM Ellison (1984-1986),14,2,2,0,0,2,2 (2ct 0st),0.142
GW Humpage (1981-1981),3,2,2,0,2,0,1 (1ct 0st),0.666
P Lever (1971-1975),9,2,2,0,0,2,1 (1ct 0st),0.222
GD Lloyd (1996-1998),6,2,2,0,0,2,1 (1ct 0st),0.333
JE Morris (1990-1991),8,2,2,0,0,2,1 (1ct 0st),0.250
NV Radford (1988-1988),6,2,2,0,0,2,2 (2ct 0st),0.333
GRJ Roope (1973-1978),7,2,2,0,0,2,1 (1ct 0st),0.285
GB Stevenson (1980-1981),4,2,2,0,0,2,1 (1ct 0st),0.500
RJW Topley (2015-2016),10,2,2,0,0,2,1 (1ct 0st),0.200
JP Agnew (1985-1985),3,1,1,0,0,1,1 (1ct 0st),0.333
Kabir Ali (2003-2006),13,1,1,0,0,1,1 (1ct 0st),0.076
RJ Bailey (1985-1990),4,1,1,0,0,1,1 (1ct 0st),0.250
DR Brown (1997-1998),9,1,1,0,0,1,1 (1ct 0st),0.111
DB Close (1972-1972),3,1,1,0,0,1,1 (1ct 0st),0.333
MH Denness (1973-1975),12,1,1,0,0,1,1 (1ct 0st),0.083
"BL D'Oliveira (1971-1972)",4,1,1,0,0,1,1 (1ct 0st),0.250
MV Fleming (1997-1998),11,1,1,0,0,1,1 (1ct 0st),0.090
PJ Franks (2000-2000),1,1,1,0,0,1,1 (1ct 0st),1.000
N Gifford (1985-1985),2,1,1,0,0,1,1 (1ct 0st),0.500
AP Grayson (2000-2001),2,1,1,0,0,1,1 (1ct 0st),0.500
HF Gurney (2014-2014),10,1,1,0,0,1,1 (1ct 0st),0.100
AP Igglesden (1994-1994),4,1,1,0,0,1,1 (1ct 0st),0.250
R Illingworth (1971-1973),2,1,1,0,0,1,1 (1ct 0st),0.500
PW Jarvis (1988-1993),16,1,1,0,0,1,1 (1ct 0st),0.062
JD Love (1981-1981),3,1,1,0,0,1,1 (1ct 0st),0.333
MJ Lumb (2014-2014),3,1,1,0,0,1,1 (1ct 0st),0.333
MA Lynch (1988-1988),3,1,1,0,0,1,1 (1ct 0st),0.333
DL Maddy (1998-2000),8,1,1,0,0,1,1 (1ct 0st),0.125
SI Mahmood (2004-2009),26,1,1,0,0,1,1 (1ct 0st),0.038
DE Malcolm (1990-1994),10,1,1,0,0,1,1 (1ct 0st),0.100
PJ Martin (1995-1998),20,1,1,0,0,1,1 (1ct 0st),0.050
G Onions (2009-2009),4,1,1,0,0,1,1 (1ct 0st),0.250
BC Rose (1977-1977),2,1,1,0,0,1,1 (1ct 0st),0.500
IDK Salisbury (1993-1994),4,1,1,0,0,1,1 (1ct 0st),0.250
K Shuttleworth (1971-1971),1,1,1,0,0,1,1 (1ct 0st),1.000
MJ Smith (1973-1974),5,1,1,0,0,1,1 (1ct 0st),0.200
NMK Smith (1996-1996),7,1,1,0,0,1,1 (1ct 0st),0.142
JA Snow (1971-1975),8,1,1,0,0,1,1 (1ct 0st),0.125
FJ Titmus (1975-1975),2,1,1,0,0,1,1 (1ct 0st),0.500
RW Tolchard (1979-1979),1,1,1,0,1,0,1 (1ct 0st),1.000
JO Troughton (2003-2003),5,1,1,0,0,1,1 (1ct 0st),0.200
AJ Tudor (2002-2002),3,1,1,0,0,1,1 (1ct 0st),0.333
SD Udal (1994-2005),11,1,1,0,0,1,1 (1ct 0st),0.090
AG Wharf (2004-2005),13,1,1,0,0,1,1 (1ct 0st),0.076
JJ Whitaker (1987-1987),2,1,1,0,0,1,1 (1ct 0st),0.500
ZS Ansari (2015-2015),1,0,0,0,0,0,0,0.000
ID Austin (1998-1999),9,0,0,0,0,0,0,0.000
KJ Barnett (1988-1988),1,0,0,0,0,0,0,0.000
JE Benjamin (1994-1995),2,0,0,0,0,0,0,0.000
MR Benson (1986-1986),1,0,0,0,0,0,0,0.000
SG Borthwick (2011-2011),2,0,0,0,0,0,0,0.000
DR Briggs (2012-2012),1,0,0,0,0,0,0,0.000
AR Butcher (1980-1980),1,0,0,0,0,0,0,0.000
RO Butcher (1980-1981),3,0,0,0,0,0,0,0.000
G Chapple (2006-2006),1,0,0,0,0,0,0,0.000
GA Cope (1977-1978),2,0,0,0,0,0,0,0.000
CS Cowdrey (1985-1985),3,0,0,0,0,0,0,0.000
MC Cowdrey (1971-1971),1,0,0,0,0,0,0,0.000
LA Dawson (2016-2016),1,0,0,0,0,0,0,0.000
BM Duckett (2016-2016),3,0,0,0,0,0,0,0.000
JH Edrich (1971-1975),7,0,0,0,0,0,0,0.000
JH Hampshire (1971-1972),3,0,0,0,0,0,0,0.000
FC Hayes (1973-1975),5,0,0,0,0,0,0,0.000
JA Jameson (1973-1975),3,0,0,0,0,0,0,0.000
RL Johnson (2003-2003),9,0,0,0,0,0,0,0.000
SP Jones (2004-2005),8,0,0,0,0,0,0,0.000
RWT Key (2003-2004),5,0,0,0,0,0,0,0.000
DV Lawrence (1991-1991),1,0,0,0,0,0,0,0.000
J Lewis (2005-2007),13,0,0,0,0,0,0,0.000
TA Lloyd (1984-1984),3,0,0,0,0,0,0,0.000
AGR Loudon (2006-2006),1,0,0,0,0,0,0,0.000
MB Loye (2007-2007),7,0,0,0,0,0,0,0.000
BW Luckhurst (1975-1975),3,0,0,0,0,0,0,0.000
SC Meaker (2011-2011),2,0,0,0,0,0,0,0.000
SD Parry (2014-2014),2,0,0,0,0,0,0,0.000
PI Pocock (1985-1985),1,0,0,0,0,0,0,0.000
CT Radley (1978-1978),4,0,0,0,0,0,0,0.000
WB Rankin (2013-2014),6,0,0,0,0,0,0,0.000
TS Roland-Jones (2017-2017),1,0,0,0,0,0,0,0.000
CEW Silverwood (1996-2001),7,0,0,0,0,0,0,0.000
WN Slack (1986-1986),2,0,0,0,0,0,0,0.000
CL Smith (1984-1984),4,0,0,0,0,0,0,0.000
DM Smith (1986-1990),2,0,0,0,0,0,0,0.000
DS Steele (1976-1976),1,0,0,0,0,0,0,0.000
JP Taylor (1993-1993),1,0,0,0,0,0,0,0.000
LB Taylor (1986-1986),2,0,0,0,0,0,0,0.000
JG Thomas (1986-1987),3,0,0,0,0,0,0,0.000
SL Watkin (1994-1994),4,0,0,0,0,0,0,0.000
M Watkinson (1996-1996),1,0,0,0,0,0,0,0.000
AP Wells (1995-1995),1,0,0,0,0,0,0,0.000
CM Wells (1985-1985),2,0,0,0,0,0,0,0.000
AC Gilchrist (1996-2008),285,470,416,54,416,0,6 (6ct 0st),1.649
IA Healy (1988-1997),168,233,194,39,194,0,4 (4ct 0st),1.386
BJ Haddin (2001-2015),124,181,170,11,170,0,5 (5ct 0st),1.459
RT Ponting (1995-2012),371,159,159,0,0,159,3 (3ct 0st),0.428
AR Border (1979-1994),270,127,127,0,0,127,3 (3ct 0st),0.470
RW Marsh (1971-1984),92,124,120,4,120,0,5 (5ct 0st),1.347
MS Wade (2012-2017),94,117,108,9,108,0,5 (5ct 0st),1.244
SR Waugh (1986-2002),324,111,111,0,0,111,3 (3ct 0st),0.342
ME Waugh (1988-2002),243,108,108,0,0,108,3 (3ct 0st),0.444
MJ Clarke (2003-2015),243,106,106,0,0,106,4 (4ct 0st),0.436
MEK Hussey (2004-2012),184,105,105,0,0,105,3 (3ct 0st),0.570
A Symonds (1998-2009),196,82,82,0,0,82,4 (4ct 0st),0.418
SK Warne (1993-2003),192,80,80,0,0,80,3 (3ct 0st),0.416
MG Bevan (1994-2004),230,69,69,0,0,69,3 (3ct 0st),0.300
DR Martyn (1992-2006),205,69,69,0,0,69,3 (3ct 0st),0.336
ML Hayden (1993-2008),157,68,68,0,0,68,2 (2ct 0st),0.433
SR Watson (2002-2015),189,64,64,0,0,64,2 (2ct 0st),0.338
SPD Smith (2010-2018),108,62,62,0,0,62,3 (3ct 0st),0.574
MA Taylor (1989-1997),113,56,56,0,0,56,4 (4ct 0st),0.495
DM Jones (1984-1994),164,54,54,0,0,54,2 (2ct 0st),0.329
B Lee (2000-2012),217,54,54,0,0,54,3 (3ct 0st),0.248
GJ Maxwell (2012-2018),82,50,50,0,0,50,4 (4ct 0st),0.609
WB Phillips (1982-1986),48,49,42,7,42,0,4 (3ct 1st),1.020
DA Warner (2009-2018),106,49,49,0,0,49,2 (2ct 0st),0.462
GJ Bailey (2012-2016),90,48,48,0,0,48,3 (3ct 0st),0.533
TD Paine (2009-2018),30,47,43,4,43,0,5 (5ct 0st),1.566
DC Boon (1984-1995),181,45,45,0,0,45,2 (2ct 0st),0.248
AJ Finch (2013-2018),89,43,43,0,0,43,3 (3ct 0st),0.483
CL White (2005-2018),90,37,37,0,0,37,3 (3ct 0st),0.411
GB Hogg (1996-2008),121,36,36,0,0,36,2 (2ct 0st),0.297
GD McGrath (1993-2007),247,36,36,0,0,36,3 (3ct 0st),0.145
MG Johnson (2005-2015),152,35,35,0,0,35,2 (2ct 0st),0.230
PL Taylor (1987-1992),83,34,34,0,0,34,2 (2ct 0st),0.409
GR Marsh (1986-1992),117,31,31,0,0,31,2 (2ct 0st),0.264
TM Alderman (1981-1991),65,29,29,0,0,29,3 (3ct 0st),0.446
DJ Hussey (2008-2013),69,29,29,0,0,29,2 (2ct 0st),0.420
GC Dyer (1986-1988),23,28,24,4,24,0,4 (4ct 0st),1.217
KJ Hughes (1977-1985),96,27,27,0,0,27,2 (2ct 0st),0.281
CJ McDermott (1985-1996),138,27,27,0,0,27,1 (1ct 0st),0.195
NW Bracken (2001-2009),116,26,26,0,0,26,2 (2ct 0st),0.224
DS Lehmann (1996-2005),116,26,26,0,0,26,3 (3ct 0st),0.224
JR Hopes (2005-2010),83,25,25,0,0,25,2 (2ct 0st),0.301
MR Marsh (2011-2018),53,25,25,0,0,25,4 (4ct 0st),0.471
PR Reiffel (1992-1999),92,25,25,0,0,25,2 (2ct 0st),0.271
NM Hauritz (2002-2011),57,24,24,0,0,24,2 (2ct 0st),0.421
GS Chappell (1971-1983),72,23,23,0,0,23,2 (2ct 0st),0.319
S Lee (1995-2001),44,23,23,0,0,23,2 (2ct 0st),0.522
GRJ Matthews (1984-1993),59,23,23,0,0,23,3 (3ct 0st),0.389
TJ Zoehrer (1986-1994),22,23,21,2,21,0,4 (4ct 0st),1.045
"SP O'Donnell (1985-1991)",87,22,22,0,0,22,2 (2ct 0st),0.252
JP Faulkner (2013-2017),69,21,21,0,0,21,1 (1ct 0st),0.304
TM Moody (1987-1999),76,21,21,0,0,21,2 (2ct 0st),0.276
AJ Bichel (1997-2004),66,19,19,0,0,19,2 (2ct 0st),0.287
XJ Doherty (2010-2015),60,19,19,0,0,19,2 (2ct 0st),0.316
MA Starc (2010-2018),72,19,19,0,0,19,1 (1ct 0st),0.263
KC Wessels (1983-1985),52,19,19,0,0,19,2 (2ct 0st),0.365
GF Lawson (1980-1989),79,18,18,0,0,18,2 (2ct 0st),0.227
JP Maher (1998-2003),26,18,18,0,8,10,3 (3ct 0st),0.692
IJ Harvey (1997-2004),72,17,17,0,0,17,2 (2ct 0st),0.236
GM Wood (1978-1989),80,17,17,0,0,17,2 (2ct 0st),0.212
BJ Hodge (2005-2007),25,16,16,0,0,16,2 (2ct 0st),0.640
DW Fleming (1994-2001),88,14,14,0,0,14,1 (1ct 0st),0.159
MS Kasprowicz (1995-2005),42,13,13,0,0,13,2 (2ct 0st),0.309
SM Katich (2001-2006),45,13,13,0,0,13,1 (1ct 0st),0.288
SE Marsh (2008-2018),54,13,13,0,0,13,2 (2ct 0st),0.240
DE Bollinger (2009-2011),39,12,12,0,0,12,1 (1ct 0st),0.307
J Dyson (1980-1983),29,12,12,0,0,12,3 (3ct 0st),0.413
JR Hazlewood (2010-2018),41,12,12,0,0,12,2 (2ct 0st),0.292
TM Head (2016-2018),35,12,12,0,0,12,2 (2ct 0st),0.342
SG Law (1994-1999),54,12,12,0,0,12,2 (2ct 0st),0.222
AC Dale (1997-2000),30,11,11,0,0,11,1 (1ct 0st),0.366
DW Hookes (1977-1986),37,11,11,0,0,11,2 (2ct 0st),0.297
SJ Rixon (1978-1985),6,11,9,2,9,0,4 (2ct 2st),1.833
MR Whitney (1983-1993),38,11,11,0,0,11,3 (3ct 0st),0.289
DT Christian (2012-2014),19,10,10,0,0,10,2 (2ct 0st),0.526
SR Clark (2005-2009),39,10,10,0,0,10,2 (2ct 0st),0.256
JN Gillespie (1996-2005),97,10,10,0,0,10,1 (1ct 0st),0.103
BW Hilfenhaus (2007-2012),25,10,10,0,0,10,2 (2ct 0st),0.400
TG Hogan (1983-1984),15,10,10,0,0,10,2 (2ct 0st),0.666
DK Lillee (1972-1983),63,10,10,0,0,10,2 (2ct 0st),0.158
KD Walters (1971-1981),28,10,10,0,0,10,3 (3ct 0st),0.357
GM Ritchie (1982-1987),44,9,9,0,0,9,2 (2ct 0st),0.204
MJ Slater (1993-1997),42,9,9,0,0,9,2 (2ct 0st),0.214
JR Thomson (1975-1985),50,9,9,0,0,9,2 (2ct 0st),0.180
TM Chappell (1980-1983),20,8,8,0,0,8,2 (2ct 0st),0.400
RM Hogg (1979-1985),69,8,8,0,0,8,1 (1ct 0st),0.115
BP Julian (1993-1999),25,8,8,0,0,8,2 (2ct 0st),0.320
SB Smith (1983-1985),27,8,8,0,0,8,1 (1ct 0st),0.296
SW Tait (2007-2011),35,8,8,0,0,8,2 (2ct 0st),0.228
MRJ Veletta (1987-1989),20,8,8,0,1,7,3 (3ct 0st),0.400
DM Wellham (1981-1987),17,8,8,0,0,8,2 (2ct 0st),0.470
KJ Wright (1979-1979),5,8,8,0,8,0,2 (2ct 0st),1.600
GS Blewett (1995-1999),32,7,7,0,0,7,2 (2ct 0st),0.218
NM Coulter-Nile (2013-2017),21,7,7,0,0,7,1 (1ct 0st),0.333
AIC Dodemaide (1988-1993),24,7,7,0,0,7,2 (2ct 0st),0.291
CJ Ferguson (2009-2011),29,7,7,0,0,7,2 (2ct 0st),0.241
CJ McKay (2009-2014),59,7,7,0,0,7,3 (3ct 0st),0.118
L Ronchi (2008-2008),4,7,5,2,5,0,3 (2ct 1st),1.750
AC Voges (2007-2013),31,7,7,0,0,7,2 (2ct 0st),0.225
A Zampa (2016-2018),31,7,7,0,0,7,1 (1ct 0st),0.225
PJ Cummins (2011-2018),39,6,6,0,0,6,2 (2ct 0st),0.153
WM Darling (1978-1982),17,6,6,0,0,6,3 (3ct 0st),0.352
PSP Handscomb (2017-2017),8,6,6,0,5,1,3 (3ct 0st),0.750
RJ Harris (2009-2012),21,6,6,0,0,6,1 (1ct 0st),0.285
MG Hughes (1988-1993),33,6,6,0,0,6,1 (1ct 0st),0.181
LS Pascoe (1977-1982),29,6,6,0,0,6,1 (1ct 0st),0.206
CG Rackemann (1983-1991),52,6,6,0,0,6,1 (1ct 0st),0.115
BA Reid (1986-1992),61,6,6,0,0,6,2 (2ct 0st),0.098
MHN Walker (1974-1981),17,6,6,0,0,6,1 (1ct 0st),0.352
RJ Campbell (2002-2002),2,5,4,1,4,0,3 (2ct 1st),2.500
IM Chappell (1971-1980),16,5,5,0,0,5,2 (2ct 0st),0.312
SP Davis (1986-1988),39,5,5,0,0,5,1 (1ct 0st),0.128
JW Hastings (2010-2017),29,5,5,0,0,5,2 (2ct 0st),0.172
PJ Hughes (2013-2014),25,5,5,0,2,3,2 (2ct 0st),0.200
BM Laird (1979-1982),23,5,5,0,0,5,1 (1ct 0st),0.217
GA Manou (2009-2009),4,5,5,0,5,0,3 (3ct 0st),1.250
GN Yallop (1978-1984),27,5,5,0,0,5,2 (2ct 0st),0.185
GD Campbell (1989-1990),12,4,4,0,0,4,1 (1ct 0st),0.333
GJ Cosier (1975-1979),8,4,4,0,0,4,2 (2ct 0st),0.500
PJ Forrest (2012-2012),15,4,4,0,0,4,1 (1ct 0st),0.266
MC Henriques (2009-2017),11,4,4,0,0,4,2 (2ct 0st),0.363
MF Kent (1981-1981),5,4,4,0,0,4,2 (2ct 0st),0.800
AA Mallett (1971-1975),9,4,4,0,0,4,1 (1ct 0st),0.444
RD Robinson (1977-1977),2,4,3,1,3,0,4 (3ct 1st),2.000
RB Simpson (1978-1978),2,4,4,0,0,4,2 (2ct 0st),2.000
MP Stoinis (2015-2018),14,4,4,0,0,4,1 (1ct 0st),0.285
BA Williams (2002-2004),24,4,4,0,0,4,2 (2ct 0st),0.166
SM Boland (2016-2016),14,3,3,0,0,3,1 (1ct 0st),0.214
PA Emery (1994-1994),1,3,3,0,3,0,3 (3ct 0st),3.000
DR Gilbert (1986-1986),14,3,3,0,0,3,1 (1ct 0st),0.214
PA Jaques (2006-2007),6,3,3,0,0,3,1 (1ct 0st),0.500
UT Khawaja (2013-2017),18,3,3,0,0,3,1 (1ct 0st),0.166
JL Langer (1994-1997),8,3,2,1,1,1,1 (1ct 0st),0.375
RB McCosker (1975-1982),14,3,3,0,0,3,1 (1ct 0st),0.214
TBA May (1987-1995),47,3,3,0,0,3,2 (2ct 0st),0.063
JL Pattinson (2011-2015),15,3,3,0,0,3,1 (1ct 0st),0.200
KW Richardson (2013-2018),16,3,3,0,0,3,1 (1ct 0st),0.187
GR Robertson (1994-1998),13,3,3,0,0,3,1 (1ct 0st),0.230
A Turner (1975-1975),6,3,3,0,0,3,2 (2ct 0st),0.500
AC Agar (2015-2018),5,2,2,0,0,2,1 (1ct 0st),0.400
RJ Bright (1974-1986),11,2,2,0,0,2,1 (1ct 0st),0.181
JA Burns (2015-2015),6,2,2,0,0,2,1 (1ct 0st),0.333
IW Callen (1978-1982),5,2,2,0,0,2,1 (1ct 0st),0.400
DJ Cullen (2006-2006),5,2,2,0,0,2,1 (1ct 0st),0.400
GJ Gilmour (1974-1975),5,2,2,0,0,2,1 (1ct 0st),0.400
JJ Krejza (2011-2011),8,2,2,0,0,2,1 (1ct 0st),0.250
B Laughlin (2009-2009),5,2,2,0,0,2,1 (1ct 0st),0.400
NM Lyon (2012-2016),13,2,2,0,0,2,1 (1ct 0st),0.153
SCG MacGill (2000-2000),3,2,2,0,0,2,1 (1ct 0st),0.666
KH MacLeay (1983-1987),16,2,2,0,0,2,1 (1ct 0st),0.125
JN Maguire (1983-1984),21,2,2,0,0,2,1 (1ct 0st),0.095
JK Moss (1979-1979),1,2,2,0,0,2,2 (2ct 0st),2.000
IR Redpath (1971-1975),5,2,2,0,0,2,1 (1ct 0st),0.400
AM Stuart (1997-1997),3,2,2,0,0,2,2 (2ct 0st),0.666
JM Wiener (1979-1980),7,2,2,0,0,2,1 (1ct 0st),0.285
RD Woolley (1983-1983),2,2,1,1,1,0,2 (1ct 1st),1.000
BE Young (1998-1999),6,2,2,0,0,2,1 (1ct 0st),0.333
MJ Bennett (1984-1985),8,1,1,0,0,1,1 (1ct 0st),0.125
GA Bishop (1987-1987),2,1,1,0,0,1,1 (1ct 0st),0.500
AT Carey (2018-2018),1,1,1,0,1,0,1 (1ct 0st),1.000
HWR Cartwright (2017-2017),2,1,1,0,0,1,1 (1ct 0st),0.500
BCJ Cutting (2013-2014),4,1,1,0,0,1,1 (1ct 0st),0.250
MJ Di Venuto (1997-1997),9,1,1,0,0,1,1 (1ct 0st),0.111
G Dymock (1974-1980),14,1,1,0,0,1,1 (1ct 0st),0.071
B Geeves (2008-2009),2,1,1,0,0,1,1 (1ct 0st),0.500
SF Graf (1980-1981),11,1,1,0,0,1,1 (1ct 0st),0.090
AMJ Hilditch (1979-1985),8,1,1,0,0,1,1 (1ct 0st),0.125
AG Hurst (1975-1979),7,1,1,0,0,1,1 (1ct 0st),0.142
RB Kerr (1985-1985),4,1,1,0,0,1,1 (1ct 0st),0.250
WM Lawry (1971-1971),1,1,1,0,0,1,1 (1ct 0st),1.000
ML Lewis (2005-2006),7,1,1,0,0,1,1 (1ct 0st),0.142
RJ McCurdy (1985-1985),11,1,1,0,0,1,1 (1ct 0st),0.090
GD McKenzie (1971-1971),1,1,1,0,0,1,1 (1ct 0st),1.000
MF Malone (1977-1982),10,1,1,0,0,1,1 (1ct 0st),0.100
RAL Massie (1972-1972),3,1,1,0,0,1,1 (1ct 0st),0.333
MJ North (2009-2009),2,1,1,0,0,1,1 (1ct 0st),0.500
JS Paris (2016-2016),2,1,1,0,0,1,1 (1ct 0st),0.500
GD Porter (1979-1979),2,1,1,0,0,1,1 (1ct 0st),0.500
CS Serjeant (1977-1978),3,1,1,0,0,1,1 (1ct 0st),0.333
PM Siddle (2009-2010),16,1,1,0,0,1,1 (1ct 0st),0.062
KR Stackpole (1971-1974),6,1,1,0,0,1,1 (1ct 0st),0.166
CP Tremain (2016-2016),4,1,1,0,0,1,1 (1ct 0st),0.250
AJ Tye (2018-2018),5,1,1,0,0,1,1 (1ct 0st),0.200
P Wilson (1997-1998),11,1,1,0,0,1,1 (1ct 0st),0.090
DJ Worrall (2016-2016),3,1,1,0,0,1,1 (1ct 0st),0.333
B Yardley (1978-1983),5,1,1,0,0,1,1 (1ct 0st),0.200
AK Zesers (1987-1987),2,1,1,0,0,1,1 (1ct 0st),0.500
SA Abbott (2014-2014),1,0,0,0,0,0,0,0.000
J Angel (1994-1995),3,0,0,0,0,0,0,0.000
GR Beard (1981-1981),2,0,0,0,0,0,0,0.000
PH Carlson (1979-1979),3,0,0,0,0,0,0,0.000
WM Clark (1978-1978),2,0,0,0,0,0,0,0.000
DJ Colley (1972-1972),1,0,0,0,0,0,0,0.000
AN Connolly (1971-1971),1,0,0,0,0,0,0,0.000
MJ Cosgrove (2006-2006),3,0,0,0,0,0,0,0.000
IC Davis (1974-1977),3,0,0,0,0,0,0,0.000
BR Dorey (2006-2006),4,0,0,0,0,0,0,0.000
R Edwards (1972-1975),9,0,0,0,0,0,0,0.000
WJ Edwards (1975-1975),1,0,0,0,0,0,0,0.000
MTG Elliott (1997-1997),1,0,0,0,0,0,0,0.000
Fawad Ahmed (2013-2013),3,0,0,0,0,0,0,0.000
JR Hammond (1972-1972),1,0,0,0,0,0,0,0.000
SM Harwood (2009-2009),1,0,0,0,0,0,0,0.000
SD Heazlett (2017-2017),1,0,0,0,0,0,0,0.000
RG Holland (1985-1985),2,0,0,0,0,0,0,0.000
TJ Jenner (1975-1975),1,0,0,0,0,0,0,0.000
TJ Laughlin (1978-1979),6,0,0,0,0,0,0,0.000
CA Lynn (2017-2017),1,0,0,0,0,0,0,0.000
JA Maclean (1979-1979),1,0,0,0,0,0,0,0.000
JM Mennie (2016-2016),2,0,0,0,0,0,0,0.000
DP Nannes (2009-2009),1,0,0,0,0,0,0,0.000
MG Neser (2018-2018),1,0,0,0,0,0,0,0.000
AA Noffke (2008-2008),1,0,0,0,0,0,0,0.000
"KJ O'Keeffe (1977-1977)",2,0,0,0,0,0,0,0.000
JA Richardson (2018-2018),1,0,0,0,0,0,0,0.000
GS Sandhu (2015-2015),2,0,0,0,0,0,0,0.000
AP Sheahan (1972-1972),3,0,0,0,0,0,0,0.000
JD Siddons (1988-1988),1,0,0,0,0,0,0,0.000
B Stanlake (2017-2018),3,0,0,0,0,0,0,0.000
AL Thomson (1971-1971),1,0,0,0,0,0,0,0.000
PM Toohey (1978-1979),4,0,0,0,0,0,0,0.000
GS Trimble (1986-1986),2,0,0,0,0,0,0,0.000
GD Watson (1972-1972),2,0,0,0,0,0,0,0.000
DF Whatmore (1980-1980),1,0,0,0,0,0,0,0.000
AJ Woodcock (1974-1974),1,0,0,0,0,0,0,0.000
MV Boucher (1998-2011),286,416,395,21,394,1,6 (6ct 0st),1.454
AB de Villiers (2005-2018),218,176,171,5,93,78,5 (5ct 0st),0.807
DJ Richardson (1991-1998),121,165,148,17,148,0,5 (5ct 0st),1.363
JH Kallis (1996-2014),319,131,131,0,0,131,3 (3ct 0st),0.410
Q de Kock (2013-2018),87,122,116,6,116,0,6 (5ct 1st),1.402
HH Gibbs (1996-2010),246,108,108,0,0,108,3 (3ct 0st),0.439
JN Rhodes (1992-2003),242,105,105,0,0,105,5 (5ct 0st),0.433
GC Smith (2002-2013),195,105,105,0,0,105,4 (4ct 0st),0.538
SM Pollock (1996-2008),291,104,104,0,0,104,2 (2ct 0st),0.357
HM Amla (2008-2018),160,81,81,0,0,81,4 (4ct 0st),0.506
JP Duminy (2004-2018),180,76,76,0,0,76,3 (3ct 0st),0.422
WJ Cronje (1992-2000),186,73,73,0,0,73,2 (2ct 0st),0.392
DJ Cullinan (1993-2000),135,62,62,0,0,62,3 (3ct 0st),0.459
G Kirsten (1993-2003),183,62,61,1,1,60,3 (3ct 0st),0.338
F du Plessis (2011-2018),116,60,60,0,0,60,3 (3ct 0st),0.517
DA Miller (2010-2018),103,50,50,0,0,50,3 (3ct 0st),0.485
BM McMillan (1991-1998),77,42,42,0,0,42,3 (3ct 0st),0.545
L Klusener (1996-2004),169,35,35,0,0,35,2 (2ct 0st),0.207
J Botha (2005-2012),75,34,34,0,0,34,3 (3ct 0st),0.453
N Boje (1995-2005),111,33,33,0,0,33,2 (2ct 0st),0.297
HH Dippenaar (1999-2006),100,33,33,0,2,31,3 (3ct 0st),0.330
JM Kemp (2001-2007),78,31,31,0,0,31,3 (3ct 0st),0.397
M Ntini (1998-2009),170,30,30,0,0,30,2 (2ct 0st),0.176
KC Wessels (1991-1994),54,30,30,0,0,30,4 (4ct 0st),0.555
AJ Hall (1999-2007),87,29,29,0,0,29,2 (2ct 0st),0.333
M Morkel (2007-2018),111,29,29,0,0,29,3 (3ct 0st),0.261
AA Donald (1991-2003),162,28,28,0,0,28,2 (2ct 0st),0.172
RJ Peterson (2002-2014),79,28,28,0,0,28,2 (2ct 0st),0.354
F Behardien (2013-2018),58,27,27,0,0,27,2 (2ct 0st),0.465
AG Prince (2002-2007),48,26,26,0,0,26,4 (4ct 0st),0.541
DW Steyn (2006-2016),113,26,26,0,0,26,2 (2ct 0st),0.230
PL Symcox (1993-1999),80,23,23,0,0,23,2 (2ct 0st),0.287
RR Rossouw (2014-2016),35,22,22,0,0,22,4 (4ct 0st),0.628
ND McKenzie (2000-2009),64,21,21,0,0,21,3 (3ct 0st),0.328
A Nel (2001-2008),77,21,21,0,0,21,2 (2ct 0st),0.272
DN Crookes (1994-2000),32,20,20,0,0,20,2 (2ct 0st),0.625
AC Hudson (1991-1997),88,18,18,0,0,18,2 (2ct 0st),0.204
Imran Tahir (2011-2018),83,17,17,0,0,17,2 (2ct 0st),0.204
PS de Villiers (1992-1997),82,15,15,0,0,15,2 (2ct 0st),0.182
JA Morkel (2004-2012),56,15,15,0,0,15,2 (2ct 0st),0.267
JL Ontong (2001-2012),26,14,14,0,0,14,2 (2ct 0st),0.538
R McLaren (2009-2014),52,13,13,0,0,13,1 (1ct 0st),0.250
K Rabada (2015-2018),47,13,13,0,0,13,2 (2ct 0st),0.276
CA Ingram (2010-2013),31,12,12,0,0,12,2 (2ct 0st),0.387
WD Parnell (2009-2017),62,12,12,0,0,12,2 (2ct 0st),0.193
PN Kirsten (1991-1994),40,11,11,0,0,11,2 (2ct 0st),0.275
CK Langeveldt (2001-2010),71,11,11,0,0,11,1 (1ct 0st),0.154
JA Rudolph (2003-2006),43,11,11,0,0,11,2 (2ct 0st),0.255
MN van Wyk (2003-2015),17,11,10,1,9,1,4 (4ct 0st),0.647
CR Matthews (1991-1997),55,10,10,0,0,10,2 (2ct 0st),0.181
S Elworthy (1998-2002),38,9,9,0,0,9,3 (3ct 0st),0.236
SJ Palframan (1996-1996),7,9,9,0,9,0,3 (3ct 0st),1.285
LL Tsotsobe (2009-2013),60,9,9,0,0,9,2 (2ct 0st),0.150
MJR Rindel (1994-1999),22,8,8,0,0,8,2 (2ct 0st),0.363
KJ Abbott (2013-2016),27,7,7,0,0,7,2 (2ct 0st),0.259
PR Adams (1996-2003),24,7,7,0,0,7,2 (2ct 0st),0.291
H Klaasen (2018-2018),4,7,7,0,7,0,3 (3ct 0st),1.750
RP Snell (1991-1996),42,7,7,0,0,7,1 (1ct 0st),0.166
DJ Callaghan (1992-2000),28,6,6,0,0,6,2 (2ct 0st),0.214
CH Morris (2013-2018),33,6,6,0,0,6,1 (1ct 0st),0.181
VD Philander (2007-2015),28,6,6,0,0,6,2 (2ct 0st),0.214
EO Simons (1994-1995),23,6,6,0,0,6,1 (1ct 0st),0.260
AN Petersen (2006-2013),21,5,5,0,0,5,1 (1ct 0st),0.238
AL Phehlukwayo (2016-2018),25,5,5,0,0,5,2 (2ct 0st),0.200
N Pothas (2000-2000),3,5,4,1,4,0,3 (2ct 1st),1.666
ELR Stewart (1993-2002),6,5,5,0,5,0,2 (2ct 0st),0.833
AM Bacher (1997-2005),13,4,4,0,0,4,2 (2ct 0st),0.307
M Hayward (1998-2002),21,4,4,0,0,4,1 (1ct 0st),0.190
RK Kleinveldt (2013-2013),10,4,4,0,0,4,2 (2ct 0st),0.400
AK Markram (2017-2018),7,4,4,0,0,4,1 (1ct 0st),0.571
AM Phangiso (2013-2016),21,4,4,0,0,4,1 (1ct 0st),0.190
R Telemachus (1998-2006),37,4,4,0,0,4,1 (1ct 0st),0.108
J Theron (2010-2010),4,4,4,0,0,4,2 (2ct 0st),1.000
M van Jaarsveld (2002-2004),11,4,4,0,0,4,1 (1ct 0st),0.363
DM Benkenstein (1998-2002),23,3,3,0,0,3,1 (1ct 0st),0.130
LE Bosman (2006-2010),13,3,3,0,0,3,2 (2ct 0st),0.230
CE Eksteen (1991-1994),6,3,3,0,0,3,1 (1ct 0st),0.500
D Elgar (2012-2015),6,3,3,0,0,3,2 (2ct 0st),0.500
SD Jack (1994-1995),2,3,3,0,0,3,2 (2ct 0st),1.500
LJ Koen (1997-2000),5,3,3,0,0,3,2 (2ct 0st),0.600
AP Kuiper (1991-1996),25,3,3,0,0,3,1 (1ct 0st),0.120
D Pretorius (2016-2017),12,3,3,0,0,3,2 (2ct 0st),0.250
DB Rundle (1994-1994),2,3,3,0,0,3,2 (2ct 0st),1.500
PC Strydom (2000-2000),10,3,3,0,0,3,2 (2ct 0st),0.300
RE van der Merwe (2009-2010),13,3,3,0,0,3,1 (1ct 0st),0.230
JJ van der Wath (2006-2007),10,3,3,0,0,3,1 (1ct 0st),0.300
M Zondeki (2002-2008),11,3,3,0,0,3,1 (1ct 0st),0.272
AC Dawson (1998-2004),19,2,2,0,0,2,1 (1ct 0st),0.105
PL Harris (2008-2008),3,2,2,0,0,2,1 (1ct 0st),0.666
D Paterson (2017-2017),3,2,2,0,0,2,2 (2ct 0st),0.666
MW Pringle (1992-1994),17,2,2,0,0,2,1 (1ct 0st),0.117
TG Shaw (1991-1994),9,2,2,0,0,2,1 (1ct 0st),0.222
HS Williams (1999-2000),7,2,2,0,0,2,2 (2ct 0st),0.285
S Abrahams (2000-2000),1,1,1,0,0,1,1 (1ct 0st),1.000
T Bavuma (2016-2017),2,1,1,0,0,1,1 (1ct 0st),0.500
GH Bodi (2007-2007),2,1,1,0,0,1,1 (1ct 0st),0.500
RE Bryson (1997-1997),7,1,1,0,0,1,1 (1ct 0st),0.142
SJ Cook (1991-1993),4,1,1,0,0,1,1 (1ct 0st),0.250
O Henry (1992-1992),3,1,1,0,0,1,1 (1ct 0st),0.333
JC Kent (2002-2002),2,1,1,0,0,1,1 (1ct 0st),0.500
GJP Kruger (2006-2006),3,1,1,0,0,1,1 (1ct 0st),0.333
L Ngidi (2018-2018),4,1,1,0,0,1,1 (1ct 0st),0.250
AG Puttick (2005-2005),1,1,1,0,0,1,1 (1ct 0st),1.000
MW Rushmere (1992-1992),4,1,1,0,0,1,1 (1ct 0st),0.250
T Shamsi (2016-2018),7,1,1,0,0,1,1 (1ct 0st),0.142
VB van Jaarsveld (2009-2009),2,1,1,0,0,1,1 (1ct 0st),0.500
M Yachad (1991-1991),1,1,1,0,0,1,1 (1ct 0st),1.000
K Zondo (2018-2018),3,1,1,0,0,1,1 (1ct 0st),0.333
T Bosch (1992-1992),2,0,0,0,0,0,0,0.000
H Davids (2013-2013),1,0,0,0,0,0,0,0.000
M de Lange (2012-2016),4,0,0,0,0,0,0,0.000
CW Henderson (2001-2001),4,0,0,0,0,0,0,0.000
GFJ Liebenberg (1995-1998),4,0,0,0,0,0,0,0.000
J Louw (2008-2008),3,0,0,0,0,0,0,0.000
KA Maharaj (2017-2017),2,0,0,0,0,0,0,0.000
PV Mpitsang (1999-1999),2,0,0,0,0,0,0,0.000
PWA Mulder (2017-2017),1,0,0,0,0,0,0,0.000
CEB Rice (1991-1991),3,0,0,0,0,0,0,0.000
BN Schultz (1992-1992),1,0,0,0,0,0,0,0.000
M Shezi (2014-2014),1,0,0,0,0,0,0,0.000
PJR Steyn (1995-1995),1,0,0,0,0,0,0,0.000
DJ Terbrugge (2000-2000),4,0,0,0,0,0,0,0.000
MS Tshabalala (2007-2007),4,0,0,0,0,0,0,0.000
CJPG van Zyl (1992-1992),2,0,0,0,0,0,0,0.000
D Wiese (2015-2016),6,0,0,0,0,0,0,0.000
CM Willoughby (2000-2003),3,0,0,0,0,0,0,0.000
PJL Dujon (1981-1991),168,204,183,21,183,0,4 (4ct 0st),1.214
RD Jacobs (1996-2004),145,189,160,29,160,0,6 (5ct 1st),1.303
D Ramdin (2005-2016),137,188,181,7,181,0,5 (5ct 0st),1.372
CL Hooper (1987-2003),225,120,120,0,0,120,4 (4ct 0st),0.533
CH Gayle (1999-2018),273,118,118,0,0,118,3 (3ct 0st),0.432
BC Lara (1990-2007),292,117,117,0,0,117,3 (3ct 0st),0.400
IVA Richards (1975-1991),186,100,100,0,0,100,3 (3ct 0st),0.537
RB Richardson (1983-1996),222,75,75,0,0,75,4 (4ct 0st),0.337
JC Adams (1992-2001),127,73,68,5,26,42,5 (4ct 1st),0.574
DJ Bravo (2004-2014),161,73,73,0,0,73,3 (3ct 0st),0.453
S Chanderpaul (1994-2011),264,73,73,0,0,73,2 (2ct 0st),0.276
CO Browne (1995-2005),46,68,59,9,59,0,5 (5ct 0st),1.478
DJG Sammy (2004-2015),124,67,67,0,0,67,3 (3ct 0st),0.540
AL Logie (1981-1993),158,61,61,0,0,61,3 (3ct 0st),0.386
DL Haynes (1978-1994),236,59,59,0,0,59,2 (2ct 0st),0.250
RA Harper (1983-1996),105,55,55,0,0,55,3 (3ct 0st),0.523
PV Simmons (1987-1999),143,55,55,0,0,55,4 (4ct 0st),0.384
JR Murray (1992-1999),55,53,46,7,44,2,3 (3ct 0st),0.963
KA Pollard (2007-2016),99,53,53,0,0,53,4 (4ct 0st),0.535
CS Baugh (2003-2012),46,51,39,12,39,0,4 (2ct 2st),1.108
MN Samuels (2000-2018),199,50,50,0,0,50,2 (2ct 0st),0.251
CEL Ambrose (1988-2000),175,45,45,0,0,45,3 (3ct 0st),0.257
CG Greenidge (1975-1991),127,45,45,0,0,45,2 (2ct 0st),0.354
RR Sarwan (2000-2013),176,45,45,0,0,45,2 (2ct 0st),0.255
D Williams (1988-1997),35,45,35,10,35,0,4 (4ct 0st),1.285
RL Powell (1999-2005),107,43,43,0,0,43,3 (3ct 0st),0.401
CH Lloyd (1973-1985),87,39,39,0,0,39,3 (3ct 0st),0.448
DL Murray (1973-1980),26,38,37,1,37,0,4 (4ct 0st),1.461
SD Hope (2016-2018),32,36,32,4,32,0,4 (4ct 0st),1.125
JO Holder (2013-2018),76,31,31,0,0,31,2 (2ct 0st),0.407
DR Smith (2004-2015),103,31,31,0,0,31,2 (2ct 0st),0.300
DM Bravo (2009-2016),92,30,30,0,0,30,3 (3ct 0st),0.326
J Garner (1977-1987),98,30,30,0,0,30,3 (3ct 0st),0.306
MA Holding (1976-1987),102,30,30,0,0,30,3 (3ct 0st),0.294
WW Hinds (1999-2010),119,29,29,0,0,29,2 (2ct 0st),0.243
DC Thomas (2009-2013),21,29,23,6,23,0,3 (3ct 0st),1.380
LMP Simmons (2006-2015),68,28,28,0,2,26,2 (2ct 0st),0.411
KLT Arthurton (1988-1999),104,27,27,0,0,27,2 (2ct 0st),0.259
CA Walsh (1985-2000),204,27,27,0,0,27,1 (1ct 0st),0.132
SL Campbell (1994-2001),90,23,23,0,0,23,3 (3ct 0st),0.255
J Charles (2012-2016),48,22,21,1,10,11,2 (2ct 0st),0.458
M Dillon (1997-2005),107,20,20,0,0,20,2 (2ct 0st),0.186
RS Morton (2002-2010),55,20,20,0,0,20,3 (3ct 0st),0.363
JE Taylor (2003-2017),88,20,20,0,0,20,2 (2ct 0st),0.227
NO Miller (2008-2018),48,18,18,0,0,18,3 (3ct 0st),0.375
SC Williams (1994-1999),57,18,18,0,0,18,3 (3ct 0st),0.315
KAJ Roach (2008-2018),71,17,17,0,0,17,2 (2ct 0st),0.239
WKM Benjamin (1986-1995),85,16,16,0,0,16,1 (1ct 0st),0.188
DA Murray (1973-1981),10,16,16,0,16,0,3 (3ct 0st),1.600
MD Marshall (1980-1992),134,15,15,0,0,15,2 (2ct 0st),0.111
EAE Baptiste (1983-1990),43,14,14,0,0,14,2 (2ct 0st),0.325
HA Gomes (1978-1987),83,14,14,0,0,14,1 (1ct 0st),0.168
SP Narine (2011-2016),65,14,14,0,0,14,2 (2ct 0st),0.215
R Rampaul (2003-2015),89,14,14,0,0,14,2 (2ct 0st),0.157
AR Nurse (2016-2018),32,13,13,0,0,13,3 (3ct 0st),0.406
DBL Powell (2002-2009),55,13,13,0,0,13,2 (2ct 0st),0.236
DS Smith (2003-2013),46,13,13,0,0,13,3 (3ct 0st),0.282
IR Bishop (1988-1997),83,12,12,0,0,12,1 (1ct 0st),0.144
CD Collymore (1999-2007),83,12,12,0,0,12,2 (2ct 0st),0.144
AC Cummins (1991-1995),62,11,11,0,0,11,1 (1ct 0st),0.177
D Ganga (1999-2006),35,11,11,0,0,11,2 (2ct 0st),0.314
E Lewis (2016-2018),31,11,11,0,0,11,2 (2ct 0st),0.354
R Powell (2016-2018),22,11,11,0,0,11,2 (2ct 0st),0.500
AD Russell (2011-2015),51,11,11,0,0,11,1 (1ct 0st),0.215
PA Wallace (1991-2000),32,11,11,0,0,11,2 (2ct 0st),0.343
SFAF Bacchus (1978-1983),29,10,10,0,0,10,2 (2ct 0st),0.344
KOA Powell (2009-2017),38,10,10,0,0,10,2 (2ct 0st),0.263
CAK Walton (2009-2017),9,10,9,1,6,3,4 (4ct 0st),1.111
SJ Benn (2008-2016),46,9,9,0,0,9,1 (1ct 0st),0.195
CR Brathwaite (2011-2018),28,9,9,0,0,9,1 (1ct 0st),0.321
N Deonarine (2005-2015),31,9,9,0,0,9,2 (2ct 0st),0.290
NC McGarrell (1998-2001),17,9,9,0,0,9,2 (2ct 0st),0.529
XM Marshall (2005-2009),23,9,9,0,0,9,2 (2ct 0st),0.391
BP Patterson (1986-1993),58,9,9,0,0,9,1 (1ct 0st),0.155
PT Collins (1999-2005),30,8,8,0,0,8,2 (2ct 0st),0.266
ADS Fletcher (2008-2016),25,8,5,3,2,3,3 (1ct 2st),0.320
RIC Holder (1993-1997),37,8,8,0,0,8,3 (3ct 0st),0.216
AI Kallicharran (1973-1981),31,8,8,0,0,8,2 (2ct 0st),0.258
NAM McLean (1996-2003),45,8,8,0,0,8,2 (2ct 0st),0.177
DR Parry (1978-1980),6,8,8,0,0,8,2 (2ct 0st),1.333
LR Williams (1996-2001),15,8,8,0,0,8,2 (2ct 0st),0.533
DE Bernard (2003-2010),19,7,7,0,0,7,1 (1ct 0st),0.368
JL Carter (2015-2017),27,7,7,0,0,7,2 (2ct 0st),0.259
RN Lewis (1997-2009),28,7,7,0,0,7,1 (1ct 0st),0.250
IDR Bradshaw (2004-2007),62,6,6,0,0,6,1 (1ct 0st),0.096
S Chattergoon (2006-2009),17,6,6,0,0,6,2 (2ct 0st),0.352
VA Holder (1973-1978),12,6,6,0,0,6,1 (1ct 0st),0.500
CL King (1976-1980),18,6,6,0,0,6,1 (1ct 0st),0.333
MV Nagamootoo (2000-2002),24,6,6,0,0,6,1 (1ct 0st),0.250
TRO Payne (1984-1987),7,6,6,0,2,4,2 (2ct 0st),0.857
AME Roberts (1975-1983),56,6,6,0,0,6,1 (1ct 0st),0.107
FA Rose (1997-2000),27,6,6,0,0,6,1 (1ct 0st),0.222
CA Best (1986-1992),23,5,5,0,0,5,2 (2ct 0st),0.217
CE Cuffy (1994-2002),41,5,5,0,0,5,1 (1ct 0st),0.121
WW Daniel (1978-1984),18,5,5,0,0,5,1 (1ct 0st),0.277
VC Drakes (1995-2004),34,5,5,0,0,5,1 (1ct 0st),0.147
SE Findlay (2008-2009),9,5,5,0,0,5,2 (2ct 0st),0.555
AFG Griffith (1996-2000),9,5,5,0,0,5,2 (2ct 0st),0.555
RC Haynes (1989-1991),8,5,5,0,0,5,2 (2ct 0st),0.625
RO Hurley (2003-2004),9,5,5,0,0,5,2 (2ct 0st),0.555
AS Joseph (2016-2017),13,5,5,0,0,5,1 (1ct 0st),0.384
DM Richards (2009-2010),8,5,5,0,0,5,2 (2ct 0st),0.625
KCG Benjamin (1992-1996),26,4,4,0,0,4,2 (2ct 0st),0.153
TL Best (2004-2014),26,4,4,0,0,4,1 (1ct 0st),0.153
D Bishoo (2011-2018),28,4,4,0,0,4,1 (1ct 0st),0.142
HR Bryan (1999-1999),15,4,4,0,0,4,1 (1ct 0st),0.266
RL Chase (2017-2017),7,4,4,0,0,4,1 (1ct 0st),0.571
ST Clarke (1978-1982),10,4,4,0,0,4,1 (1ct 0st),0.400
FH Edwards (2003-2009),49,4,4,0,0,4,1 (1ct 0st),0.081
RC Fredericks (1973-1977),12,4,4,0,0,4,1 (1ct 0st),0.333
SO Hetmyer (2017-2018),9,4,4,0,3,1,3 (3ct 0st),0.444
SC Joseph (2000-2005),13,4,4,0,0,4,1 (1ct 0st),0.307
BD Julien (1973-1977),12,4,4,0,0,4,1 (1ct 0st),0.333
RB Kanhai (1973-1975),7,4,4,0,0,4,1 (1ct 0st),0.571
RD King (1998-2005),50,4,4,0,0,4,1 (1ct 0st),0.080
NO Perry (1999-2000),21,4,4,0,0,4,3 (3ct 0st),0.190
AB Barath (2010-2012),13,3,3,0,0,3,1 (1ct 0st),0.230
KC Brathwaite (2016-2017),10,3,3,0,0,3,1 (1ct 0st),0.300
OD Gibson (1995-1997),15,3,3,0,0,3,1 (1ct 0st),0.200
AH Gray (1985-1991),25,3,3,0,0,3,1 (1ct 0st),0.120
A Martin (2011-2011),9,3,3,0,0,3,1 (1ct 0st),0.333
JN Mohammed (2011-2018),25,3,3,0,0,3,1 (1ct 0st),0.120
MR Pydanna (1980-1983),3,3,2,1,2,0,1 (1ct 0st),1.000
FL Reifer (1997-2009),8,3,3,0,0,3,1 (1ct 0st),0.375
PA Browne (2008-2008),5,2,2,0,2,0,1 (1ct 0st),0.400
TM Dowlin (2009-2010),11,2,2,0,0,2,1 (1ct 0st),0.181
KA Edwards (2011-2014),16,2,2,0,0,2,1 (1ct 0st),0.125
RO Hinds (2001-2004),14,2,2,0,0,2,1 (1ct 0st),0.142
LR Johnson (2008-2015),6,2,2,0,0,2,1 (1ct 0st),0.333
EH Mattis (1981-1981),2,2,2,0,0,2,1 (1ct 0st),1.000
KMA Paul (2018-2018),4,2,2,0,0,2,1 (1ct 0st),0.500
LG Rowe (1975-1980),11,2,2,0,0,2,1 (1ct 0st),0.181
KF Semple (1999-1999),7,2,2,0,0,2,1 (1ct 0st),0.285
IT Shillingford (1978-1978),2,2,2,0,0,2,1 (1ct 0st),1.000
LS Baker (2008-2009),9,1,1,0,0,1,1 (1ct 0st),0.111
J Blackwood (2015-2015),2,1,1,0,0,1,1 (1ct 0st),0.500
SS Cottrell (2015-2018),5,1,1,0,0,1,1 (1ct 0st),0.200
CEH Croft (1977-1981),19,1,1,0,0,1,1 (1ct 0st),0.052
ML Cummins (2014-2017),10,1,1,0,0,1,1 (1ct 0st),0.100
WW Davis (1983-1988),35,1,1,0,0,1,1 (1ct 0st),0.028
R Dhanraj (1994-1995),6,1,1,0,0,1,1 (1ct 0st),0.166
RR Emrit (2007-2007),2,1,1,0,0,1,1 (1ct 0st),0.500
RS Gabriel (1984-1984),11,1,1,0,0,1,1 (1ct 0st),0.090
ST Gabriel (2016-2017),18,1,1,0,0,1,1 (1ct 0st),0.055
KA Hope (2017-2017),7,1,1,0,0,1,1 (1ct 0st),0.142
DP Hyatt (2011-2011),9,1,1,0,0,1,1 (1ct 0st),0.111
D Mohammed (2006-2008),7,1,1,0,0,1,1 (1ct 0st),0.142
BP Nash (2008-2009),8,1,1,0,0,1,1 (1ct 0st),0.125
V Permaul (2012-2017),7,1,1,0,0,1,1 (1ct 0st),0.142
ACL Richards (2007-2007),1,1,1,0,0,1,1 (1ct 0st),1.000
RG Samuels (1996-1997),8,1,1,0,0,1,1 (1ct 0st),0.125
MA Small (1984-1984),2,1,1,0,0,1,1 (1ct 0st),0.500
GS Sobers (1973-1973),1,1,1,0,0,1,1 (1ct 0st),1.000
CEL Stuart (2001-2001),5,1,1,0,0,1,1 (1ct 0st),0.200
SW Ambris (2017-2017),1,0,0,0,0,0,0,0.000
HAG Anthony (1995-1995),3,0,0,0,0,0,0,0.000
RA Austin (1978-1978),1,0,0,0,0,0,0,0.000
OAC Banks (2003-2005),5,0,0,0,0,0,0,0.000
RR Beaton (2017-2017),2,0,0,0,0,0,0,0.000
MI Black (2001-2001),5,0,0,0,0,0,0,0.000
KD Boyce (1973-1975),8,0,0,0,0,0,0,0.000
D Brown (2001-2002),3,0,0,0,0,0,0,0.000
BS Browne (1994-1994),4,0,0,0,0,0,0,0.000
DK Butler (2005-2006),5,0,0,0,0,0,0,0.000
RT Crandon (2009-2009),1,0,0,0,0,0,0,0.000
MLC Foster (1973-1973),2,0,0,0,0,0,0,0.000
LV Garrick (2001-2001),3,0,0,0,0,0,0,0.000
LR Gibbs (1973-1975),3,0,0,0,0,0,0,0.000
AE Greenidge (1978-1978),1,0,0,0,0,0,0,0.000
RGA Headley (1973-1973),1,0,0,0,0,0,0,0.000
KCB Jeremy (2000-2001),6,0,0,0,0,0,0,0.000
CB Lambert (1990-1998),11,0,0,0,0,0,0,0.000
JJC Lawson (2001-2005),12,0,0,0,0,0,0,0.000
EA Moseley (1990-1991),8,0,0,0,0,0,0,0.000
BA Parchment (2007-2008),7,0,0,0,0,0,0,0.000
NT Pascal (2009-2009),1,0,0,0,0,0,0,0.000
N Phillip (1978-1978),1,0,0,0,0,0,0,0.000
RR Ramdass (2005-2005),1,0,0,0,0,0,0,0.000
D Ramnarine (1997-2001),4,0,0,0,0,0,0,0.000
S Shivnarine (1978-1978),1,0,0,0,0,0,0,0.000
PIC Thompson (1997-1997),2,0,0,0,0,0,0,0.000
GC Tonge (2009-2009),5,0,0,0,0,0,0,0.000
CM Tuckett (1998-1998),1,0,0,0,0,0,0,0.000
KOK Williams (2017-2018),8,0,0,0,0,0,0,0.000
BB McCullum (2002-2016),257,277,262,15,227,35,5 (5ct 0st),1.077
AC Parore (1992-2002),178,141,116,25,111,5,5 (3ct 2st),0.792
SP Fleming (1994-2007),275,132,132,0,0,132,4 (4ct 0st),0.480
LRPL Taylor (2006-2018),200,130,130,0,0,130,4 (4ct 0st),0.650
L Ronchi (2013-2017),79,110,100,10,100,0,4 (4ct 0st),1.392
CZ Harris (1990-2004),247,96,96,0,0,96,4 (4ct 0st),0.388
IDS Smith (1980-1992),97,86,81,5,80,1,3 (3ct 0st),0.886
DL Vettori (1997-2015),285,86,86,0,0,86,2 (2ct 0st),0.301
NJ Astle (1995-2007),219,83,83,0,0,83,3 (3ct 0st),0.378
MJ Guptill (2009-2018),157,76,76,0,0,76,4 (4ct 0st),0.484
SB Styris (1999-2011),185,73,73,0,0,73,3 (3ct 0st),0.394
CL Cairns (1991-2006),213,66,66,0,0,66,3 (3ct 0st),0.309
MD Crowe (1982-1995),141,66,66,0,0,66,3 (3ct 0st),0.468
TWM Latham (2012-2018),72,54,49,5,23,26,5 (3ct 2st),0.750
KS Williamson (2010-2018),126,53,53,0,0,53,3 (3ct 0st),0.420
JDP Oram (2001-2012),159,51,51,0,0,51,2 (2ct 0st),0.320
JG Wright (1978-1992),147,51,51,0,0,51,2 (2ct 0st),0.346
CD McMillan (1997-2007),193,44,44,0,0,44,2 (2ct 0st),0.227
KD Mills (2001-2015),169,42,42,0,0,42,3 (3ct 0st),0.248
NL McCullum (2009-2015),83,41,41,0,0,41,4 (4ct 0st),0.493
KR Rutherford (1985-1995),121,41,41,0,0,41,4 (4ct 0st),0.338
L Vincent (2001-2007),100,41,41,0,2,39,2 (2ct 0st),0.410
JV Coney (1979-1987),86,40,40,0,0,40,3 (3ct 0st),0.465
TE Blain (1986-1994),38,38,37,1,36,1,4 (4ct 0st),1.000
TG Southee (2008-2018),132,37,37,0,0,37,3 (3ct 0st),0.280
RG Twose (1995-2001),87,37,37,0,0,37,2 (2ct 0st),0.425
MJ Greatbatch (1988-1996),84,35,35,0,1,34,2 (2ct 0st),0.416
LK Germon (1994-1997),37,30,21,9,21,0,4 (4ct 0st),0.810
WK Lees (1979-1983),31,30,28,2,28,0,4 (4ct 0st),0.967
JJ Crowe (1983-1990),74,28,28,0,0,28,2 (2ct 0st),0.378
GJ Hopkins (2004-2010),23,28,27,1,27,0,5 (5ct 0st),1.217
BA Young (1990-1999),73,28,28,0,6,22,3 (3ct 0st),0.383
Sir RJ Hadlee (1973-1990),113,27,27,0,0,27,2 (2ct 0st),0.238
JEC Franklin (2001-2013),109,26,26,0,0,26,2 (2ct 0st),0.238
DJ Nash (1992-2002),80,25,25,0,0,25,3 (3ct 0st),0.312
AH Jones (1987-1995),87,23,23,0,0,23,2 (2ct 0st),0.264
GR Larsen (1990-1999),121,23,23,0,0,23,1 (1ct 0st),0.190
DN Patel (1987-1997),75,23,23,0,0,23,2 (2ct 0st),0.306
AF Milne (2012-2017),39,21,21,0,0,21,3 (3ct 0st),0.538
MJ Santner (2015-2018),52,21,21,0,0,21,2 (2ct 0st),0.403
DR Tuffey (2000-2010),92,20,20,0,0,20,3 (3ct 0st),0.217
BJ Watling (2010-2016),27,20,20,0,14,6,3 (3ct 0st),0.740
JG Bracewell (1983-1990),52,19,19,0,0,19,3 (3ct 0st),0.365
BL Cairns (1974-1985),77,19,19,0,0,19,2 (2ct 0st),0.246
EJ Chatfield (1979-1989),112,19,19,0,0,19,2 (2ct 0st),0.169
JM How (2005-2011),40,19,19,0,0,19,4 (4ct 0st),0.475
DK Morrison (1987-1996),96,19,19,0,0,19,2 (2ct 0st),0.197
CJ Nevin (2000-2003),36,19,16,3,14,2,3 (3ct 0st),0.527
MC Snedden (1980-1990),92,19,19,0,0,19,1 (1ct 0st),0.206
PG Fulton (2004-2009),48,18,18,0,0,18,2 (2ct 0st),0.375
HJH Marshall (2003-2007),65,18,18,0,0,18,3 (3ct 0st),0.276
SA Thomson (1990-1996),56,18,18,0,0,18,2 (2ct 0st),0.321
GD Elliott (2008-2016),83,17,17,0,0,17,2 (2ct 0st),0.204
EB McSweeney (1986-1987),15,17,14,3,14,0,3 (3ct 0st),1.133
JDS Neesham (2013-2017),41,17,17,0,0,17,2 (2ct 0st),0.414
MS Sinclair (2000-2009),54,17,17,0,2,15,2 (2ct 0st),0.314
GP Howarth (1975-1985),69,16,16,0,0,16,2 (2ct 0st),0.231
C Munro (2013-2018),40,16,16,0,0,16,1 (1ct 0st),0.400
SE Bond (2002-2010),80,15,15,0,0,15,2 (2ct 0st),0.187
TA Boult (2012-2018),66,15,15,0,0,15,2 (2ct 0st),0.227
JD Ryder (2008-2014),48,15,15,0,0,15,2 (2ct 0st),0.312
CM Spearman (1995-2001),51,15,15,0,0,15,1 (1ct 0st),0.294
KJ Wadsworth (1973-1976),13,15,13,2,13,0,3 (3ct 0st),1.153
JS Patel (2005-2017),42,13,13,0,0,13,1 (1ct 0st),0.309
GM Turner (1973-1983),41,13,13,0,0,13,2 (2ct 0st),0.317
BA Edgar (1978-1986),63,12,12,0,0,12,2 (2ct 0st),0.190
MJ Horne (1997-2002),49,12,12,0,0,12,2 (2ct 0st),0.244
HM Nicholls (2015-2018),26,12,12,0,0,12,2 (2ct 0st),0.461
JM Parker (1974-1981),24,12,11,1,0,11,3 (3ct 0st),0.500
CJ Anderson (2013-2017),48,11,11,0,0,11,2 (2ct 0st),0.229
MJ Henry (2014-2018),33,11,11,0,0,11,2 (2ct 0st),0.333
RT Latham (1990-1994),33,11,11,0,0,11,2 (2ct 0st),0.333
RJ Nicol (2011-2013),22,11,11,0,0,11,2 (2ct 0st),0.500
"SB O'Connor (1997-2000)",38,11,11,0,0,11,2 (2ct 0st),0.289
SB Doull (1992-2000),42,10,10,0,0,10,2 (2ct 0st),0.238
NT Broom (2009-2017),39,9,9,0,0,9,2 (2ct 0st),0.230
CM Kuggeleijn (1988-1989),16,9,9,0,0,9,2 (2ct 0st),0.562
W Watson (1986-1994),61,9,9,0,0,9,1 (1ct 0st),0.147
AR Adams (2001-2007),41,8,8,0,0,8,2 (2ct 0st),0.195
MG Burgess (1973-1981),26,8,8,0,0,8,2 (2ct 0st),0.307
IG Butler (2002-2010),25,8,8,0,0,8,2 (2ct 0st),0.320
SR Gillespie (1986-1988),19,7,7,0,0,7,2 (2ct 0st),0.368
MN Hart (1994-2002),13,7,7,0,0,7,2 (2ct 0st),0.538
PD McGlashan (2009-2009),4,7,7,0,7,0,3 (3ct 0st),1.750
CS Martin (2001-2008),19,7,7,0,0,7,1 (1ct 0st),0.368
C Pringle (1990-1995),64,7,7,0,0,7,1 (1ct 0st),0.109
DG Brownlie (2012-2017),16,6,6,0,0,6,1 (1ct 0st),0.375
CD Cumming (2003-2009),13,6,6,0,0,6,2 (2ct 0st),0.461
MR Gillespie (2006-2009),31,6,6,0,0,6,2 (2ct 0st),0.193
JFM Morrison (1975-1983),18,6,6,0,0,6,2 (2ct 0st),0.333
GI Allott (1997-2000),31,5,5,0,0,5,1 (1ct 0st),0.161
SL Boock (1978-1987),13,5,5,0,0,5,1 (1ct 0st),0.384
GN Edwards (1976-1981),6,5,5,0,2,3,2 (2ct 0st),0.833
BR Hartland (1992-1994),16,5,5,0,0,5,1 (1ct 0st),0.312
JF Reid (1980-1986),23,5,5,0,0,5,1 (1ct 0st),0.217
BGK Walker (2000-2002),11,5,5,0,0,5,1 (1ct 0st),0.454
BR Blair (1982-1986),13,4,4,0,0,4,2 (2ct 0st),0.307
C de Grandhomme (2012-2018),19,4,4,0,0,4,1 (1ct 0st),0.210
LH Ferguson (2016-2018),16,4,4,0,0,4,1 (1ct 0st),0.250
DR Flynn (2008-2012),20,4,4,0,0,4,1 (1ct 0st),0.200
BF Hastings (1973-1975),11,4,4,0,0,4,2 (2ct 0st),0.363
PA Hitchcock (2002-2008),13,4,4,0,0,4,1 (1ct 0st),0.307
MJ McClenaghan (2013-2016),46,4,4,0,0,4,1 (1ct 0st),0.086
MJ Mason (2003-2010),25,4,4,0,0,4,1 (1ct 0st),0.160
IS Sodhi (2015-2018),21,4,4,0,0,4,1 (1ct 0st),0.190
RH Vance (1988-1989),8,4,4,0,0,4,2 (2ct 0st),0.500
JTC Vaughan (1992-1996),18,4,4,0,0,4,1 (1ct 0st),0.222
JW Wilson (1993-2005),6,4,4,0,0,4,2 (2ct 0st),0.666
HK Bennett (2010-2017),16,3,3,0,0,3,1 (1ct 0st),0.187
DAJ Bracewell (2011-2017),16,3,3,0,0,3,1 (1ct 0st),0.187
AP Devcich (2013-2016),12,3,3,0,0,3,1 (1ct 0st),0.250
AM Ellis (2012-2013),15,3,3,0,0,3,2 (2ct 0st),0.200
EJ Gray (1984-1988),10,3,3,0,0,3,2 (2ct 0st),0.300
HJ Howarth (1973-1975),9,3,3,0,0,3,1 (1ct 0st),0.333
PJ Ingram (2010-2010),8,3,3,0,0,3,1 (1ct 0st),0.375
AJ McKay (2010-2012),19,3,3,0,0,3,1 (1ct 0st),0.157
SHA Rance (2017-2017),2,3,3,0,0,3,3 (3ct 0st),1.500
AJ Redmond (2009-2010),6,3,3,0,0,3,1 (1ct 0st),0.500
RB Reid (1988-1991),9,3,3,0,0,3,1 (1ct 0st),0.333
DA Stirling (1984-1984),6,3,3,0,0,3,1 (1ct 0st),0.500
PN Webb (1983-1984),5,3,3,0,3,0,1 (1ct 0st),0.600
TD Astle (2017-2018),6,2,2,0,0,2,1 (1ct 0st),0.333
GE Bradburn (1990-2001),11,2,2,0,0,2,1 (1ct 0st),0.181
VR Brown (1988-1988),3,2,2,0,0,2,1 (1ct 0st),0.666
PG Coman (1973-1974),3,2,2,0,0,2,1 (1ct 0st),0.666
HT Davis (1994-1997),11,2,2,0,0,2,1 (1ct 0st),0.181
RP de Groen (1993-1994),12,2,2,0,0,2,1 (1ct 0st),0.166
MW Douglas (1994-1995),6,2,2,0,0,2,1 (1ct 0st),0.333
DR Hadlee (1973-1976),11,2,2,0,0,2,1 (1ct 0st),0.181
LG Howell (1998-1998),12,2,2,0,0,2,1 (1ct 0st),0.166
BJ McKechnie (1975-1981),14,2,2,0,0,2,1 (1ct 0st),0.142
TS Nethula (2012-2012),5,2,2,0,0,2,1 (1ct 0st),0.400
RG Petrie (1990-1991),12,2,2,0,0,2,1 (1ct 0st),0.166
MW Priest (1990-1998),18,2,2,0,0,2,1 (1ct 0st),0.111
GK Robertson (1981-1989),10,2,2,0,0,2,1 (1ct 0st),0.200
HD Rutherford (2013-2013),4,2,2,0,0,2,1 (1ct 0st),0.500
GB Troup (1976-1985),22,2,2,0,0,2,1 (1ct 0st),0.090
MDJ Walker (2003-2003),3,2,2,0,0,2,1 (1ct 0st),0.666
PJ Wiseman (1998-2003),14,2,2,0,0,2,1 (1ct 0st),0.142
GH Worker (2015-2017),7,2,2,0,0,2,2 (2ct 0st),0.285
RW Anderson (1976-1978),2,1,1,0,0,1,1 (1ct 0st),0.500
MD Bates (2012-2012),2,1,1,0,0,1,1 (1ct 0st),0.500
MD Bell (1998-2001),7,1,1,0,0,1,1 (1ct 0st),0.142
CE Bulfin (1999-1999),4,1,1,0,0,1,1 (1ct 0st),0.250
TK Canning (2003-2005),4,1,1,0,0,1,1 (1ct 0st),0.250
RO Collinge (1973-1978),15,1,1,0,0,1,1 (1ct 0st),0.066
BJ Diamanti (2009-2009),1,1,1,0,0,1,1 (1ct 0st),1.000
CJ Drum (1999-1999),5,1,1,0,0,1,1 (1ct 0st),0.200
RG Hart (2002-2002),2,1,1,0,1,0,1 (1ct 0st),0.500
RJ Kennedy (1996-1996),7,1,1,0,0,1,1 (1ct 0st),0.142
PE McEwan (1980-1985),17,1,1,0,0,1,1 (1ct 0st),0.058
JP Millmow (1990-1990),5,1,1,0,0,1,1 (1ct 0st),0.200
"IE O'Brien (2008-2009)",10,1,1,0,0,1,1 (1ct 0st),0.100
MHW Papps (2004-2005),6,1,1,0,0,1,1 (1ct 0st),0.166
NM Parker (1976-1976),1,1,1,0,0,1,1 (1ct 0st),1.000
AJ Penn (1997-2001),5,1,1,0,0,1,1 (1ct 0st),0.200
V Pollard (1973-1974),3,1,1,0,0,1,1 (1ct 0st),0.333
MH Richardson (2002-2002),4,1,1,0,0,1,1 (1ct 0st),0.250
ADG Roberts (1976-1976),1,1,1,0,0,1,1 (1ct 0st),1.000
LW Stott (1979-1979),1,1,1,0,0,1,1 (1ct 0st),1.000
"ML Su'a (1992-1995)",12,1,1,0,0,1,1 (1ct 0st),0.083
BR Taylor (1973-1973),2,1,1,0,0,1,1 (1ct 0st),0.500
BM Wheeler (2015-2015),6,1,1,0,0,1,1 (1ct 0st),0.166
DJ White (1990-1990),3,1,1,0,0,1,1 (1ct 0st),0.333
WA Wisneski (2000-2000),3,1,1,0,0,1,1 (1ct 0st),0.333
GW Aldridge (2011-2011),2,0,0,0,0,0,0,0.000
MD Bailey (1998-1998),1,0,0,0,0,0,0,0.000
BP Bracewell (1978-1978),1,0,0,0,0,0,0,0.000
MS Chapman (2018-2018),3,0,0,0,0,0,0,0.000
BE Congdon (1973-1978),11,0,0,0,0,0,0,0.000
TJ Franklin (1983-1988),3,0,0,0,0,0,0,0.000
BG Hadlee (1975-1975),2,0,0,0,0,0,0,0.000
LJ Hamilton (2005-2005),2,0,0,0,0,0,0,0.000
RT Hart (1985-1985),1,0,0,0,0,0,0,0.000
MJ Haslam (1992-1992),1,0,0,0,0,0,0,0.000
RL Hayes (1995-1995),1,0,0,0,0,0,0,0.000
PA Horne (1987-1987),4,0,0,0,0,0,0,0.000
RA Jones (2003-2003),5,0,0,0,0,0,0,0.000
SC Kuggeleijn (2017-2017),2,0,0,0,0,0,0,0.000
JAH Marshall (2005-2008),10,0,0,0,0,0,0,0.000
AW Mathieson (2015-2015),1,0,0,0,0,0,0,0.000
DJ Murray (1994-1994),1,0,0,0,0,0,0,0.000
"DR O'Sullivan (1974-1976)",3,0,0,0,0,0,0,0.000
MB Owens (1992-1992),1,0,0,0,0,0,0,0.000
RE Redmond (1973-1973),2,0,0,0,0,0,0,0.000
SJ Roberts (1990-1990),2,0,0,0,0,0,0,0.000
SL Stewart (2010-2010),4,0,0,0,0,0,0,0.000
GP Sulzberger (2000-2000),3,0,0,0,0,0,0,0.000
AR Tait (1998-1999),5,0,0,0,0,0,0,0.000
EP Thompson (2009-2009),1,0,0,0,0,0,0,0.000
GE Vivian (1973-1973),1,0,0,0,0,0,0,0.000
KP Walmsley (2003-2003),2,0,0,0,0,0,0,0.000
RJ Webb (1983-1983),3,0,0,0,0,0,0,0.000
LJ Woodcock (2011-2011),4,0,0,0,0,0,0,0.000
MS Dhoni (2004-2018),310,398,294,104,294,0,6 (5ct 1st),1.283
R Dravid (1996-2011),337,210,196,14,72,124,4 (4ct 0st),0.623
M Azharuddin (1985-2000),332,156,156,0,0,156,4 (4ct 0st),0.469
NR Mongia (1994-2000),139,154,110,44,110,0,5 (4ct 1st),1.107
SR Tendulkar (1989-2012),456,140,140,0,0,140,4 (4ct 0st),0.307
V Kohli (2008-2018),206,100,100,0,0,100,3 (3ct 0st),0.485
SK Raina (2005-2015),220,100,100,0,0,100,3 (3ct 0st),0.454
SC Ganguly (1992-2007),306,99,99,0,0,99,3 (3ct 0st),0.323
Yuvraj Singh (2000-2017),295,93,93,0,0,93,3 (3ct 0st),0.315
KS More (1984-1993),93,90,63,27,63,0,5 (3ct 2st),0.967
V Sehwag (1999-2013),236,90,90,0,0,90,3 (3ct 0st),0.381
A Kumble (1990-2007),266,85,85,0,0,85,2 (2ct 0st),0.319
Harbhajan Singh (1998-2015),229,71,71,0,0,71,3 (3ct 0st),0.310
N Kapil Dev (1978-1994),222,71,71,0,0,71,3 (3ct 0st),0.319
KD Karthik (2004-2017),79,60,53,7,30,23,4 (4ct 0st),0.759
RG Sharma (2007-2018),179,60,60,0,0,60,3 (3ct 0st),0.335
A Jadeja (1992-2000),195,59,59,0,0,59,2 (2ct 0st),0.302
M Kaif (2002-2006),122,55,55,0,0,55,4 (4ct 0st),0.450
AB Agarkar (1998-2007),188,52,52,0,0,52,2 (2ct 0st),0.276
RA Jadeja (2009-2017),135,51,51,0,0,51,2 (2ct 0st),0.377
AM Rahane (2011-2018),87,48,48,0,0,48,2 (2ct 0st),0.551
S Dhawan (2010-2018),100,46,46,0,0,46,2 (2ct 0st),0.460
Z Khan (2000-2012),191,43,43,0,0,43,3 (3ct 0st),0.225
K Srikkanth (1981-1992),145,42,42,0,0,42,2 (2ct 0st),0.289
RJ Shastri (1981-1992),148,40,40,0,0,40,2 (2ct 0st),0.270
VVS Laxman (1998-2006),85,39,39,0,0,39,4 (4ct 0st),0.458
PA Patel (2003-2012),36,39,30,9,30,0,4 (3ct 1st),1.083
BKV Prasad (1994-2001),160,37,37,0,0,37,3 (3ct 0st),0.231
DB Vengsarkar (1976-1991),127,37,37,0,0,37,3 (3ct 0st),0.291
G Gambhir (2003-2013),144,36,36,0,0,36,3 (3ct 0st),0.250
SMH Kirmani (1976-1986),48,36,27,9,27,0,5 (5ct 0st),0.750
RR Singh (1989-2001),135,33,33,0,0,33,2 (2ct 0st),0.244
J Srinath (1991-2003),227,32,32,0,0,32,2 (2ct 0st),0.140
R Ashwin (2010-2017),110,30,30,0,0,30,3 (3ct 0st),0.272
SS Karim (1997-2000),34,30,27,3,27,0,4 (3ct 1st),0.882
CS Pandit (1986-1992),36,30,15,15,15,0,4 (2ct 2st),0.833
M Prabhakar (1984-1996),128,27,27,0,0,27,3 (3ct 0st),0.210
V Dahiya (2000-2001),19,24,19,5,19,0,3 (3ct 0st),1.263
SS Dighe (2000-2001),23,24,19,5,19,0,4 (4ct 0st),1.043
S Viswanath (1985-1988),22,24,17,7,17,0,5 (3ct 2st),1.090
M Amarnath (1975-1989),84,23,23,0,0,23,2 (2ct 0st),0.273
B Kumar (2012-2018),85,23,23,0,0,23,2 (2ct 0st),0.270
SV Manjrekar (1988-1996),74,23,23,0,0,23,2 (2ct 0st),0.310
SM Gavaskar (1974-1987),107,22,22,0,0,22,4 (4ct 0st),0.205
D Mongia (2001-2007),56,21,21,0,0,21,3 (3ct 0st),0.375
IK Pathan (2004-2012),118,21,21,0,0,21,1 (1ct 0st),0.177
MSK Prasad (1998-1999),17,21,14,7,14,0,5 (4ct 1st),1.235
RV Uthappa (2006-2015),44,21,19,2,4,15,3 (3ct 0st),0.477
NS Sidhu (1987-1998),135,20,20,0,0,20,2 (2ct 0st),0.148
UT Yadav (2010-2017),69,20,20,0,0,20,3 (3ct 0st),0.289
KM Jadhav (2014-2018),39,19,19,0,0,19,2 (2ct 0st),0.487
SB Joshi (1996-2001),68,19,19,0,0,19,2 (2ct 0st),0.279
I Sharma (2007-2016),78,19,19,0,0,19,1 (1ct 0st),0.243
V Yadav (1992-1994),19,19,12,7,12,0,3 (2ct 1st),1.000
S Madan Lal (1974-1987),65,18,18,0,0,18,2 (2ct 0st),0.276
Maninder Singh (1983-1993),58,18,18,0,0,18,2 (2ct 0st),0.310
WP Saha (2010-2014),8,18,17,1,17,0,4 (4ct 0st),2.250
A Nehra (2001-2011),117,17,17,0,0,17,2 (2ct 0st),0.145
YK Pathan (2008-2012),56,17,17,0,0,17,3 (3ct 0st),0.303
N Chopra (1998-2000),38,16,16,0,0,16,2 (2ct 0st),0.421
Mohammed Shami (2013-2017),49,16,16,0,0,16,2 (2ct 0st),0.326
HH Pandya (2016-2018),37,16,16,0,0,16,2 (2ct 0st),0.432
A Ratra (2002-2002),12,16,11,5,11,0,3 (2ct 1st),1.333
VG Kambli (1991-2000),101,15,15,0,0,15,1 (1ct 0st),0.148
AR Patel (2014-2017),36,15,15,0,0,15,2 (2ct 0st),0.416
HH Kanitkar (1997-2000),34,14,14,0,0,14,2 (2ct 0st),0.411
HK Badani (2000-2004),40,13,13,0,0,13,2 (2ct 0st),0.325
RP Singh (2005-2011),58,13,13,0,0,13,1 (1ct 0st),0.224
PK Amre (1991-1994),36,12,12,0,0,12,2 (2ct 0st),0.333
RMH Binny (1980-1987),70,12,12,0,0,12,2 (2ct 0st),0.171
JJ Bumrah (2016-2018),37,12,12,0,0,12,2 (2ct 0st),0.324
L Balaji (2002-2009),30,11,11,0,0,11,2 (2ct 0st),0.366
P Kumar (2007-2012),67,11,11,0,0,11,2 (2ct 0st),0.164
MM Patel (2006-2011),68,11,11,0,0,11,2 (2ct 0st),0.161
SM Patil (1980-1986),44,11,11,0,0,11,2 (2ct 0st),0.250
AT Rayudu (2013-2016),32,11,11,0,0,11,2 (2ct 0st),0.343
RK Chauhan (1993-1997),34,10,10,0,0,10,1 (1ct 0st),0.294
M Kartik (2002-2007),37,10,10,0,0,10,1 (1ct 0st),0.270
R Lamba (1986-1989),32,10,10,0,0,10,1 (1ct 0st),0.312
DS Mohanty (1997-2001),44,10,10,0,0,10,2 (2ct 0st),0.227
Yashpal Sharma (1978-1985),42,10,10,0,0,10,1 (1ct 0st),0.238
PP Chawla (2007-2011),25,9,9,0,0,9,3 (3ct 0st),0.360
RS Sodhi (2000-2002),18,9,9,0,0,9,2 (2ct 0st),0.500
M Vijay (2010-2015),17,9,9,0,0,9,2 (2ct 0st),0.529
SC Khanna (1979-1984),9,8,4,4,4,0,3 (1ct 2st),0.888
SLV Raju (1990-1996),52,8,8,0,0,8,1 (1ct 0st),0.153
KBJ Azad (1980-1986),24,7,7,0,0,7,2 (2ct 0st),0.291
PP Ojha (2008-2012),18,7,7,0,0,7,3 (3ct 0st),0.388
C Sharma (1983-1994),64,7,7,0,0,7,1 (1ct 0st),0.109
SK Sharma (1988-1990),23,7,7,0,0,7,2 (2ct 0st),0.304
L Sivaramakrishnan (1985-1987),16,7,7,0,0,7,3 (3ct 0st),0.437
S Sreesanth (2005-2011),52,7,7,0,0,7,1 (1ct 0st),0.134
AD Gaekwad (1975-1987),14,6,6,0,0,6,1 (1ct 0st),0.428
Harvinder Singh (1997-2001),16,6,6,0,0,6,1 (1ct 0st),0.375
JJ Martin (1999-2001),10,6,6,0,0,6,3 (3ct 0st),0.600
MK Pandey (2015-2017),22,6,6,0,0,6,1 (1ct 0st),0.272
AK Sharma (1988-1993),31,6,6,0,0,6,2 (2ct 0st),0.193
MM Sharma (2013-2015),25,6,6,0,0,6,1 (1ct 0st),0.240
Y Venugopal Rao (2005-2006),16,6,6,0,0,6,2 (2ct 0st),0.375
R Vinay Kumar (2010-2013),31,6,6,0,0,6,2 (2ct 0st),0.193
Arshad Ayub (1987-1990),32,5,5,0,0,5,1 (1ct 0st),0.156
RS Gavaskar (2004-2004),11,5,5,0,0,5,2 (2ct 0st),0.454
A Mishra (2003-2016),35,5,5,0,0,5,1 (1ct 0st),0.142
KL Rahul (2016-2017),10,5,5,0,0,5,2 (2ct 0st),0.500
BS Sandhu (1982-1984),21,5,5,0,0,5,1 (1ct 0st),0.238
J Arun Lal (1982-1989),13,4,4,0,0,4,1 (1ct 0st),0.307
SB Bangar (2002-2004),15,4,4,0,0,4,2 (2ct 0st),0.266
AC Bedade (1994-1994),12,4,4,0,0,4,1 (1ct 0st),0.333
BS Bedi (1974-1979),10,4,4,0,0,4,3 (3ct 0st),0.400
YS Chahal (2016-2018),23,4,4,0,0,4,1 (1ct 0st),0.173
FM Engineer (1974-1975),5,4,3,1,3,0,1 (1ct 0st),0.800
A Kuruvilla (1997-1997),25,4,4,0,0,4,1 (1ct 0st),0.160
AO Malhotra (1982-1986),20,4,4,0,0,4,1 (1ct 0st),0.200
GAHM Parkar (1982-1984),8,4,4,0,0,4,2 (2ct 0st),0.500
V Rathour (1996-1997),7,4,4,0,0,4,2 (2ct 0st),0.571
V Razdan (1989-1990),3,4,4,0,0,4,2 (2ct 0st),1.333
RL Sanghvi (1998-1998),10,4,4,0,0,4,2 (2ct 0st),0.400
MK Tiwary (2008-2015),11,4,4,0,0,4,3 (3ct 0st),0.363
S Venkataraghavan (1974-1983),15,4,4,0,0,4,1 (1ct 0st),0.266
R Vijay Bharadwaj (1999-2002),10,4,4,0,0,4,1 (1ct 0st),0.400
SV Bahutule (1997-2003),8,3,3,0,0,3,2 (2ct 0st),0.375
ST Banerjee (1991-1992),6,3,3,0,0,3,1 (1ct 0st),0.500
STR Binny (2014-2015),12,3,3,0,0,3,2 (2ct 0st),0.250
CPS Chauhan (1978-1981),7,3,3,0,0,3,1 (1ct 0st),0.428
D Dasgupta (2001-2001),5,3,2,1,2,0,1 (1ct 0st),0.600
DR Doshi (1980-1982),15,3,3,0,0,3,1 (1ct 0st),0.200
SS Iyer (2017-2018),6,3,3,0,0,3,2 (2ct 0st),0.500
Joginder Sharma (2004-2007),4,3,3,0,0,3,1 (1ct 0st),0.750
AR Khurasiya (1999-2001),12,3,3,0,0,3,1 (1ct 0st),0.250
T Kumaran (1999-2000),8,3,3,0,0,3,1 (1ct 0st),0.375
RR Powar (2004-2007),30,3,3,0,0,3,1 (1ct 0st),0.100
S Ramesh (1999-1999),23,3,3,0,0,3,1 (1ct 0st),0.130
KV Sharma (2014-2014),2,3,3,0,0,3,2 (2ct 0st),1.500
VRV Singh (2006-2006),2,3,3,0,0,3,2 (2ct 0st),1.500
SN Thakur (2017-2018),3,3,3,0,0,3,1 (1ct 0st),1.000
GR Viswanath (1974-1982),25,3,3,0,0,3,1 (1ct 0st),0.120
Jai P Yadav (2002-2005),12,3,3,0,0,3,2 (2ct 0st),0.250
SA Ankola (1989-1997),20,2,2,0,0,2,1 (1ct 0st),0.100
S Badrinath (2008-2011),7,2,2,0,0,2,2 (2ct 0st),0.285
KD Ghavri (1975-1981),19,2,2,0,0,2,1 (1ct 0st),0.105
ND Hirwani (1988-1992),18,2,2,0,0,2,1 (1ct 0st),0.111
P Krishnamurthy (1976-1976),1,2,1,1,1,0,2 (1ct 1st),2.000
Kuldeep Yadav (2017-2018),19,2,2,0,0,2,1 (1ct 0st),0.105
DS Kulkarni (2014-2016),12,2,2,0,0,2,1 (1ct 0st),0.166
NM Kulkarni (1997-1998),10,2,2,0,0,2,1 (1ct 0st),0.200
RR Kulkarni (1983-1987),10,2,2,0,0,2,1 (1ct 0st),0.200
JV Paranjpe (1998-1998),4,2,2,0,0,2,1 (1ct 0st),0.500
LS Rajput (1985-1987),4,2,2,0,0,2,1 (1ct 0st),0.500
WV Raman (1988-1996),27,2,2,0,0,2,1 (1ct 0st),0.074
B Reddy (1978-1981),3,2,2,0,2,0,1 (1ct 0st),0.666
AM Salvi (2003-2003),4,2,2,0,0,2,1 (1ct 0st),0.500
Sarandeep Singh (2002-2003),5,2,2,0,0,2,1 (1ct 0st),0.400
G Sharma (1985-1987),11,2,2,0,0,2,1 (1ct 0st),0.181
ED Solkar (1974-1976),7,2,2,0,0,2,1 (1ct 0st),0.285
SS Tiwary (2010-2010),3,2,2,0,0,2,1 (1ct 0st),0.666
PS Vaidya (1995-1996),4,2,2,0,0,2,1 (1ct 0st),0.500
AS Wassan (1990-1991),9,2,2,0,0,2,1 (1ct 0st),0.222
B Yograj Singh (1980-1981),6,2,2,0,0,2,1 (1ct 0st),0.333
VR Aaron (2011-2014),9,1,1,0,0,1,1 (1ct 0st),0.111
S Amarnath (1978-1978),3,1,1,0,0,1,1 (1ct 0st),0.333
U Chatterjee (1995-1995),3,1,1,0,0,1,1 (1ct 0st),0.333
AB Dinda (2010-2013),13,1,1,0,0,1,1 (1ct 0st),0.076
Gurkeerat Singh (2016-2016),3,1,1,0,0,1,1 (1ct 0st),0.333
Gursharan Singh (1990-1990),1,1,1,0,0,1,1 (1ct 0st),1.000
AR Kapoor (1995-2000),17,1,1,0,0,1,1 (1ct 0st),0.058
A Mithun (2010-2011),5,1,1,0,0,1,1 (1ct 0st),0.200
SP Mukherjee (1990-1991),3,1,1,0,0,1,1 (1ct 0st),0.333
SV Nayak (1981-1982),4,1,1,0,0,1,1 (1ct 0st),0.250
NV Ojha (2010-2010),1,1,0,1,0,0,1 (0ct 1st),1.000
Pankaj Singh (2010-2010),1,1,1,0,0,1,1 (1ct 0st),1.000
AK Patel (1984-1985),7,1,1,0,0,1,1 (1ct 0st),0.142
BP Patel (1974-1979),10,1,1,0,0,1,1 (1ct 0st),0.100
R Sharma (2011-2012),4,1,1,0,0,1,1 (1ct 0st),0.250
LR Shukla (1999-1999),3,1,1,0,0,1,1 (1ct 0st),0.333
BB Sran (2016-2016),6,1,1,0,0,1,1 (1ct 0st),0.166
S Sriram (2000-2004),8,1,1,0,0,1,1 (1ct 0st),0.125
R Sudhakar Rao (1976-1976),1,1,1,0,0,1,1 (1ct 0st),1.000
S Tyagi (2009-2010),4,1,1,0,0,1,1 (1ct 0st),0.250
AL Wadekar (1974-1974),2,1,1,0,0,1,1 (1ct 0st),0.500
Washington Sundar (2017-2017),1,1,1,0,0,1,1 (1ct 0st),1.000
J Yadav (2016-2016),1,1,1,0,0,1,1 (1ct 0st),1.000
NS Yadav (1986-1987),7,1,1,0,0,1,1 (1ct 0st),0.142
S Abid Ali (1974-1975),5,0,0,0,0,0,0,0.000
B Arun (1986-1987),4,0,0,0,0,0,0,0.000
A Bhandari (2000-2004),2,0,0,0,0,0,0,0.000
Bhupinder Singh snr (1994-1994),2,0,0,0,0,0,0,0.000
GK Bose (1974-1974),1,0,0,0,0,0,0,0.000
BS Chandrasekhar (1976-1976),1,0,0,0,0,0,0,0.000
VB Chandrasekhar (1988-1990),7,0,0,0,0,0,0,0.000
SS Das (2001-2002),4,0,0,0,0,0,0,0.000
NA David (1997-1997),4,0,0,0,0,0,0,0.000
P Dharmani (1996-1996),1,0,0,0,0,0,0,0.000
R Dhawan (2016-2016),3,0,0,0,0,0,0,0.000
FY Fazal (2016-2016),1,0,0,0,0,0,0,0.000
DJ Gandhi (1999-2000),3,0,0,0,0,0,0,0.000
D Ganesh (1997-1997),1,0,0,0,0,0,0,0.000
RS Ghai (1984-1986),6,0,0,0,0,0,0,0.000
MS Gony (2008-2008),2,0,0,0,0,0,0,0.000
W Jaffer (2006-2006),2,0,0,0,0,0,0,0.000
AV Kale (2003-2003),1,0,0,0,0,0,0,0.000
GK Khoda (1998-1998),2,0,0,0,0,0,0,0.000
AV Mankad (1974-1974),1,0,0,0,0,0,0,0.000
PL Mhambrey (1996-1998),3,0,0,0,0,0,0,0.000
SS Naik (1974-1974),2,0,0,0,0,0,0,0.000
KK Nair (2016-2016),2,0,0,0,0,0,0,0.000
AM Nayar (2009-2009),3,0,0,0,0,0,0,0.000
GK Pandey (1999-1999),2,0,0,0,0,0,0,0.000
Parvez Rasool (2014-2014),1,0,0,0,0,0,0,0.000
RGM Patel (1988-1988),1,0,0,0,0,0,0,0.000
CA Pujara (2013-2014),4,0,0,0,0,0,0,0.000
Randhir Singh (1981-1983),2,0,0,0,0,0,0,0.000
SS Raul (1998-1998),2,0,0,0,0,0,0,0.000
TAP Sekhar (1983-1985),4,0,0,0,0,0,0,0.000
PH Sharma (1976-1976),2,0,0,0,0,0,0,0.000
RP Singh (1986-1986),2,0,0,0,0,0,0,0.000
S Somasunder (1996-1996),2,0,0,0,0,0,0,0.000
TE Srinivasan (1980-1981),2,0,0,0,0,0,0,0.000
JD Unadkat (2013-2013),7,0,0,0,0,0,0,0.000
M Venkataramana (1988-1988),1,0,0,0,0,0,0,0.000
T Yohannan (2002-2002),3,0,0,0,0,0,0,0.000
Moin Khan (1990-2004),217,287,214,73,214,0,5 (5ct 0st),1.322
Rashid Latif (1992-2003),164,220,182,38,182,0,5 (5ct 0st),1.341
Kamran Akmal (2002-2017),154,188,157,31,156,1,5 (4ct 1st),1.220
Younis Khan (2000-2015),260,135,135,0,5,130,4 (4ct 0st),0.519
Shahid Afridi (1996-2015),387,127,127,0,0,127,2 (2ct 0st),0.328
Inzamam-ul-Haq (1991-2007),370,113,113,0,0,113,3 (3ct 0st),0.305
Sarfraz Ahmed (2007-2018),84,107,85,22,85,0,6 (6ct 0st),1.273
Saleem Yousuf (1982-1990),86,103,81,22,81,0,4 (3ct 1st),1.197
Shoaib Malik (1999-2018),259,92,92,0,0,92,2 (2ct 0st),0.355
Ijaz Ahmed (1986-2000),249,90,90,0,0,90,3 (3ct 0st),0.361
Umar Akmal (2009-2017),114,90,77,13,45,32,5 (5ct 0st),0.789
Wasim Akram (1984-2003),352,88,88,0,0,88,3 (3ct 0st),0.250
Saleem Malik (1982-1999),277,81,81,0,1,80,4 (4ct 0st),0.292
Mohammad Hafeez (2003-2018),198,76,76,0,0,76,2 (2ct 0st),0.383
Javed Miandad (1975-1996),229,73,71,2,1,70,3 (3ct 0st),0.318
Misbah-ul-Haq (2002-2015),160,66,66,0,0,66,4 (4ct 0st),0.412
Wasim Bari (1973-1984),50,62,52,10,52,0,4 (3ct 1st),1.240
Mohammad Yousuf (1998-2010),278,55,55,0,0,55,2 (2ct 0st),0.197
Aamer Sohail (1990-2000),154,49,49,0,0,49,2 (2ct 0st),0.318
Saeed Anwar (1989-2003),242,42,42,0,0,42,3 (3ct 0st),0.173
Saqlain Mushtaq (1995-2003),166,40,40,0,0,40,2 (2ct 0st),0.240
Azhar Mahmood (1996-2007),140,37,37,0,0,37,2 (2ct 0st),0.264
Imran Khan (1974-1992),172,36,36,0,0,36,3 (3ct 0st),0.209
Abdul Razzaq (1996-2011),258,35,35,0,0,35,2 (2ct 0st),0.135
Waqar Younis (1989-2003),259,35,35,0,0,35,2 (2ct 0st),0.135
Rameez Raja (1985-1997),193,33,33,0,0,33,2 (2ct 0st),0.170
Mushtaq Ahmed (1989-2003),144,30,30,0,0,30,2 (2ct 0st),0.208
Ahmed Shehzad (2009-2017),80,28,28,0,0,28,2 (2ct 0st),0.350
Imran Nazir (1999-2009),78,26,26,0,0,26,3 (3ct 0st),0.333
Saeed Ajmal (2008-2015),112,25,25,0,0,25,1 (1ct 0st),0.223
Aaqib Javed (1988-1998),159,24,24,0,0,24,1 (1ct 0st),0.150
Mohammad Rizwan (2015-2017),25,24,24,0,12,12,4 (4ct 0st),0.960
Wasim Raja (1973-1985),52,24,24,0,0,24,2 (2ct 0st),0.461
Wahab Riaz (2008-2017),78,23,23,0,0,23,2 (2ct 0st),0.294
Zulqarnain (1985-1989),14,23,18,5,18,0,4 (4ct 0st),1.642
Babar Azam (2015-2018),41,22,22,0,0,22,2 (2ct 0st),0.536
Abdul Qadir (1983-1993),102,21,21,0,0,21,2 (2ct 0st),0.205
Manzoor Elahi (1984-1995),54,21,21,0,0,21,2 (2ct 0st),0.388
Mudassar Nazar (1977-1989),119,21,21,0,0,21,2 (2ct 0st),0.176
Ashraf Ali (1980-1985),16,20,17,3,17,0,3 (3ct 0st),1.250
Salman Butt (2004-2010),77,20,20,0,0,20,2 (2ct 0st),0.259
Shoaib Akhtar (1998-2011),157,20,20,0,0,20,2 (2ct 0st),0.127
Akram Raza (1989-1995),49,19,19,0,0,19,2 (2ct 0st),0.387
Mohammad Sami (2001-2015),86,19,19,0,0,19,2 (2ct 0st),0.220
Asif Mujtaba (1986-1996),66,18,18,0,0,18,3 (3ct 0st),0.272
Umar Gul (2003-2016),128,17,17,0,0,17,2 (2ct 0st),0.132
Aamer Malik (1988-1994),24,16,13,3,10,3,2 (2ct 0st),0.666
Naved-ul-Hasan (2003-2010),72,16,16,0,0,16,2 (2ct 0st),0.222
Zaheer Abbas (1974-1985),60,16,16,0,0,16,2 (2ct 0st),0.266
Anil Dalpat (1984-1986),14,15,13,2,13,0,3 (3ct 0st),1.071
Basit Ali (1993-1996),49,15,15,0,0,15,2 (2ct 0st),0.306
Sohail Tanvir (2007-2014),60,15,15,0,0,15,2 (2ct 0st),0.250
Asad Shafiq (2010-2017),59,14,14,0,0,14,2 (2ct 0st),0.237
Imran Farhat (2001-2013),58,14,14,0,0,14,1 (1ct 0st),0.241
Mansoor Akhtar (1980-1990),40,14,14,0,0,14,2 (2ct 0st),0.350
Yasir Hameed (2003-2007),56,14,14,0,0,14,2 (2ct 0st),0.250
Mohsin Khan (1977-1986),73,13,13,0,0,13,2 (2ct 0st),0.178
Nasir Jamshed (2008-2015),48,13,13,0,0,13,2 (2ct 0st),0.270
Shoaib Mohammad (1984-1993),62,13,13,0,0,13,2 (2ct 0st),0.209
Mohammad Irfan (2010-2016),60,11,11,0,0,11,2 (2ct 0st),0.183
Tahir Naqqash (1980-1985),38,11,11,0,0,11,2 (2ct 0st),0.289
Arshad Khan (1993-2006),57,10,10,0,0,10,2 (2ct 0st),0.175
Fawad Alam (2007-2015),38,10,10,0,0,10,2 (2ct 0st),0.263
Iftikhar Anjum (2004-2010),61,10,10,0,0,10,3 (3ct 0st),0.163
Mohammad Salman (2011-2011),7,10,8,2,8,0,4 (4ct 0st),1.428
Saleem Elahi (1995-2004),47,10,10,0,0,10,2 (2ct 0st),0.212
Shabbir Ahmed (1999-2005),32,10,10,0,0,10,2 (2ct 0st),0.312
Tauseef Ahmed (1982-1990),68,10,10,0,0,10,1 (1ct 0st),0.147
Haris Sohail (2013-2018),24,9,9,0,0,9,2 (2ct 0st),0.375
Mohammad Wasim (1996-2000),25,9,9,0,0,9,2 (2ct 0st),0.360
Sohaib Maqsood (2013-2016),26,9,9,0,0,9,2 (2ct 0st),0.346
Taufeeq Umar (2001-2011),22,9,9,0,0,9,1 (1ct 0st),0.409
Azhar Ali (2011-2018),52,8,8,0,0,8,1 (1ct 0st),0.153
Fakhar Zaman (2017-2018),13,8,8,0,0,8,2 (2ct 0st),0.615
Hasan Ali (2016-2018),30,8,8,0,0,8,2 (2ct 0st),0.266
Imad Wasim (2015-2017),30,8,8,0,0,8,1 (1ct 0st),0.266
Mohammad Akram (1995-2000),21,8,8,0,0,8,2 (2ct 0st),0.380
Sarfraz Nawaz (1973-1984),45,8,8,0,0,8,1 (1ct 0st),0.177
Abdur Rehman (2006-2014),31,7,7,0,0,7,2 (2ct 0st),0.225
Asif Iqbal (1973-1979),10,7,7,0,0,7,2 (2ct 0st),0.700
Humayun Farhat (2001-2001),5,7,4,3,4,0,3 (3ct 0st),1.400
Mohammad Amir (2009-2018),40,6,6,0,0,6,2 (2ct 0st),0.150
Sharjeel Khan (2013-2017),25,6,6,0,0,6,1 (1ct 0st),0.240
Umar Amin (2010-2018),16,6,6,0,0,6,2 (2ct 0st),0.375
Junaid Khan (2011-2017),66,5,5,0,0,5,1 (1ct 0st),0.075
Mohammad Hussain (1997-1998),13,5,5,0,0,5,2 (2ct 0st),0.384
Sadiq Mohammad (1973-1980),19,5,5,0,0,5,2 (2ct 0st),0.263
Shadab Khan (2017-2018),17,5,5,0,0,5,1 (1ct 0st),0.294
Wajahatullah Wasti (1999-2000),15,5,5,0,0,5,1 (1ct 0st),0.333
Anwar Ali (2013-2016),22,4,4,0,0,4,2 (2ct 0st),0.181
Atiq-uz-Zaman (2000-2000),3,4,3,1,3,0,3 (3ct 0st),1.333
Hammad Azam (2011-2015),11,4,4,0,0,4,2 (2ct 0st),0.363
Mohsin Kamal (1984-1989),19,4,4,0,0,4,1 (1ct 0st),0.210
Qasim Umar (1983-1987),30,4,4,0,0,4,1 (1ct 0st),0.133
Shahid Nazir (1996-2000),17,4,4,0,0,4,1 (1ct 0st),0.235
Sikander Bakht (1977-1989),27,4,4,0,0,4,1 (1ct 0st),0.148
Yasir Shah (2011-2016),17,4,4,0,0,4,2 (2ct 0st),0.235
Adnan Akmal (2011-2012),5,3,3,0,3,0,1 (1ct 0st),0.600
Azeem Hafeez (1983-1985),15,3,3,0,0,3,2 (2ct 0st),0.200
Faheem Ashraf (2017-2018),8,3,3,0,0,3,1 (1ct 0st),0.375
Faisal Iqbal (2000-2006),18,3,3,0,0,3,1 (1ct 0st),0.166
Haroon Rasheed (1977-1982),12,3,3,0,0,3,1 (1ct 0st),0.250
Iqbal Qasim (1977-1988),15,3,3,0,0,3,1 (1ct 0st),0.200
Khurram Manzoor (2008-2009),7,3,3,0,0,3,1 (1ct 0st),0.428
Majid Khan (1973-1982),23,3,3,0,0,3,1 (1ct 0st),0.130
Mohammad Asif (2005-2010),33,3,3,0,0,3,1 (1ct 0st),0.090
Mushtaq Mohammad (1973-1978),10,3,3,0,0,3,1 (1ct 0st),0.300
Rashid Khan (1980-1985),28,3,3,0,0,3,1 (1ct 0st),0.107
Saleem Jaffar (1986-1990),39,3,3,0,0,3,1 (1ct 0st),0.076
Sohail Khan (2008-2016),13,3,3,0,0,3,1 (1ct 0st),0.230
Abdur Rauf (2008-2008),4,2,2,0,0,2,1 (1ct 0st),0.500
Aizaz Cheema (2011-2012),14,2,2,0,0,2,1 (1ct 0st),0.142
Azam Khan (1996-1998),6,2,2,0,0,2,1 (1ct 0st),0.333
Bilal Asif (2015-2015),3,2,2,0,0,2,2 (2ct 0st),0.666
Bilawal Bhatti (2013-2015),10,2,2,0,0,2,1 (1ct 0st),0.200
Danish Kaneria (2001-2007),18,2,2,0,0,2,1 (1ct 0st),0.111
Ijaz Faqih (1980-1988),27,2,2,0,0,2,1 (1ct 0st),0.074
Mohammad Khalil (2005-2005),3,2,2,0,0,2,1 (1ct 0st),0.666
Mohammad Nawaz (3) (2016-2018),10,2,2,0,0,2,1 (1ct 0st),0.200
Naved Latif (2001-2003),11,2,2,0,0,2,1 (1ct 0st),0.181
Pervez Mir (1975-1977),3,2,2,0,0,2,1 (1ct 0st),0.666
Rizwan-uz-Zaman (1981-1987),3,2,2,0,0,2,2 (2ct 0st),0.666
Rumman Raees (2017-2018),9,2,2,0,0,2,1 (1ct 0st),0.222
Saeed Azad (1995-1996),4,2,2,0,0,2,1 (1ct 0st),0.500
Shahid Saeed (1989-1993),10,2,2,0,0,2,1 (1ct 0st),0.200
Taslim Arif (1980-1980),2,2,1,1,0,1,1 (1ct 0st),1.000
Yasir Arafat (2000-2009),11,2,2,0,0,2,1 (1ct 0st),0.181
Zahid Fazal (1990-1994),19,2,2,0,0,2,1 (1ct 0st),0.105
Zahoor Elahi (1996-1997),14,2,2,0,0,2,1 (1ct 0st),0.142
Zulqarnain Haider (2010-2010),4,2,1,1,1,0,2 (1ct 1st),0.500
Aamer Hameed (1977-1978),2,1,1,0,0,1,1 (1ct 0st),0.500
Asif Masood (1973-1976),7,1,1,0,0,1,1 (1ct 0st),0.142
Bazid Khan (2004-2008),5,1,1,0,0,1,1 (1ct 0st),0.200
Hasan Jamil (1977-1978),6,1,1,0,0,1,1 (1ct 0st),0.166
Hasan Raza (1996-1999),15,1,1,0,0,1,1 (1ct 0st),0.066
Iftikhar Ahmed (2015-2015),2,1,1,0,0,1,1 (1ct 0st),0.500
Ijaz Ahmed jnr (1997-1997),2,1,1,0,0,1,1 (1ct 0st),0.500
Imran Abbas (2000-2000),2,1,1,0,0,1,1 (1ct 0st),0.500
Irfan Bhatti (1993-1993),1,1,1,0,0,1,1 (1ct 0st),1.000
Jalal-ud-Din (1982-1983),7,1,1,0,0,1,1 (1ct 0st),0.142
Javed Qadeer (1995-1995),1,1,1,0,1,0,1 (1ct 0st),1.000
Kabir Khan (1994-2000),9,1,1,0,0,1,1 (1ct 0st),0.111
Khalid Latif (2008-2010),5,1,1,0,0,1,1 (1ct 0st),0.200
Manzoor Akhtar (1997-1998),7,1,1,0,0,1,1 (1ct 0st),0.142
Mohammad Zahid (1996-2002),11,1,1,0,0,1,1 (1ct 0st),0.090
Naeem Ahmed (1978-1978),1,1,1,0,0,1,1 (1ct 0st),1.000
Rahat Ali (2012-2016),14,1,1,0,0,1,1 (1ct 0st),0.071
Rizwan Ahmed (2008-2008),1,1,1,0,0,1,1 (1ct 0st),1.000
Saadat Ali (1984-1984),8,1,1,0,0,1,1 (1ct 0st),0.125
Sajid Ali (1984-1997),13,1,1,0,0,1,1 (1ct 0st),0.076
Saleem Altaf (1973-1978),6,1,1,0,0,1,1 (1ct 0st),0.166
Shadab Kabir (1996-1996),3,1,1,0,0,1,1 (1ct 0st),0.333
Shafiq Ahmed (1977-1978),3,1,1,0,0,1,1 (1ct 0st),0.333
Shahid Mahboob (1982-1984),10,1,1,0,0,1,1 (1ct 0st),0.100
Sohail Fazal (1989-1989),2,1,1,0,0,1,1 (1ct 0st),0.500
Tanvir Ahmed (2011-2011),2,1,1,0,0,1,1 (1ct 0st),0.500
Usman Khan (2017-2017),2,1,1,0,0,1,1 (1ct 0st),0.500
Usman Salahuddin (2011-2011),2,1,1,0,0,1,1 (1ct 0st),0.500
Younis Ahmed (1987-1987),2,1,1,0,0,1,1 (1ct 0st),0.500
Zafar Iqbal (1995-1995),8,1,1,0,0,1,1 (1ct 0st),0.125
Aamer Hanif (1993-1995),5,0,0,0,0,0,0,0.000
Aamer Nazir (1993-1995),9,0,0,0,0,0,0,0.000
Aamer Yamin (2015-2018),4,0,0,0,0,0,0,0.000
Akhtar Sarfraz (1997-1998),4,0,0,0,0,0,0,0.000
Arshad Pervez (1978-1978),2,0,0,0,0,0,0,0.000
Asad Ali (2013-2013),4,0,0,0,0,0,0,0.000
Ashfaq Ahmed (1994-1994),3,0,0,0,0,0,0,0.000
Asif Mahmood (1998-1998),2,0,0,0,0,0,0,0.000
Ata-ur-Rehman (1992-1996),30,0,0,0,0,0,0,0.000
Azmat Rana (1978-1978),2,0,0,0,0,0,0,0.000
Ehsan Adil (2013-2015),6,0,0,0,0,0,0,0.000
Faisal Athar (2003-2003),1,0,0,0,0,0,0,0.000
Fazl-e-Akbar (1998-2001),2,0,0,0,0,0,0,0.000
Ghulam Ali (1993-1995),3,0,0,0,0,0,0,0.000
Haafiz Shahid (1988-1988),3,0,0,0,0,0,0,0.000
Imam-ul-Haq (2017-2018),4,0,0,0,0,0,0,0.000
Intikhab Alam (1973-1976),4,0,0,0,0,0,0,0.000
Iqbal Sikander (1992-1992),4,0,0,0,0,0,0,0.000
Irfan Fazil (2000-2000),1,0,0,0,0,0,0,0.000
Junaid Zia (2003-2003),4,0,0,0,0,0,0,0.000
Kamran Hussain (2008-2008),2,0,0,0,0,0,0,0.000
Kashif Raza (2001-2001),1,0,0,0,0,0,0,0.000
Liaqat Ali (1977-1978),3,0,0,0,0,0,0,0.000
Mahmood Hamid (1995-1995),1,0,0,0,0,0,0,0.000
Mansoor Amjad (2008-2008),1,0,0,0,0,0,0,0.000
Mansoor Rana (1990-1990),2,0,0,0,0,0,0,0.000
Maqsood Rana (1990-1990),1,0,0,0,0,0,0,0.000
Masood Iqbal (1984-1984),1,0,0,0,0,0,0,0.000
Mohammad Nazir (1980-1984),4,0,0,0,0,0,0,0.000
Mohammad Talha (2014-2014),3,0,0,0,0,0,0,0.000
Moin-ul-Atiq (1988-1989),5,0,0,0,0,0,0,0.000
Mujahid Jamshed (1997-1997),4,0,0,0,0,0,0,0.000
Nadeem Ghauri (1990-1990),6,0,0,0,0,0,0,0.000
Nadeem Khan (1993-1995),2,0,0,0,0,0,0,0.000
Naeem Ashraf (1995-1995),2,0,0,0,0,0,0,0.000
Najaf Shah (2007-2007),1,0,0,0,0,0,0,0.000
Naseer Malik (1975-1975),3,0,0,0,0,0,0,0.000
Nasim-ul-Ghani (1973-1973),1,0,0,0,0,0,0,0.000
Naumanullah (2008-2008),1,0,0,0,0,0,0,0.000
Naved Anjum (1984-1992),13,0,0,0,0,0,0,0.000
Raza Hasan (2014-2014),1,0,0,0,0,0,0,0.000
Saad Nasim (2015-2015),3,0,0,0,0,0,0,0.000
Sajjad Akbar (1990-1990),2,0,0,0,0,0,0,0.000
Saleem Pervez (1980-1980),1,0,0,0,0,0,0,0.000
Samiullah Khan (2008-2008),2,0,0,0,0,0,0,0.000
Sami Aslam (2015-2016),4,0,0,0,0,0,0,0.000
Shahid Anwar (1996-1996),1,0,0,0,0,0,0,0.000
Shahzaib Hasan (2010-2010),3,0,0,0,0,0,0,0.000
Shakeel Ahmed jnr (1995-1995),2,0,0,0,0,0,0,0.000
Shakeel Khan (1987-1987),1,0,0,0,0,0,0,0.000
Tanvir Mehdi (1992-1992),1,0,0,0,0,0,0,0.000
Wasim Haider (1992-1992),3,0,0,0,0,0,0,0.000
Zafar Gohar (2015-2015),1,0,0,0,0,0,0,0.000
Zahid Ahmed (1987-1987),2,0,0,0,0,0,0,0.000
Zakir Khan (1984-1990),16,0,0,0,0,0,0,0.000
Zulfiqar Babar (2014-2015),5,0,0,0,0,0,0,0.000
KC Sangakkara (2000-2015),390,492,396,96,377,19,5 (4ct 1st),1.261
DPMD Jayawardene (1998-2015),438,212,212,0,0,212,3 (3ct 0st),0.484
RS Kaluwitharana (1990-2004),188,207,132,75,131,1,5 (4ct 1st),1.101
M Muralitharan (1993-2011),340,128,128,0,0,128,3 (3ct 0st),0.376
TM Dilshan (1999-2016),325,124,123,1,5,118,3 (3ct 0st),0.381
ST Jayasuriya (1989-2011),437,123,123,0,0,123,3 (3ct 0st),0.281
RS Mahanama (1986-1999),212,109,109,0,0,109,3 (3ct 0st),0.514
PA de Silva (1984-2003),307,95,95,0,0,95,3 (3ct 0st),0.309
HP Tillakaratne (1986-2003),199,95,89,6,39,50,5 (5ct 0st),0.477
UDU Chandana (1994-2007),146,79,79,0,0,79,3 (3ct 0st),0.541
MS Atapattu (1990-2007),266,70,70,0,0,70,3 (3ct 0st),0.263
LD Chandimal (2010-2018),136,65,58,7,31,27,4 (3ct 1st),0.477
A Ranatunga (1982-1999),268,63,63,0,0,63,3 (3ct 0st),0.235
WPUJC Vaas (1994-2008),319,59,59,0,0,59,2 (2ct 0st),0.184
NLTC Perera (2009-2018),129,52,52,0,0,52,2 (2ct 0st),0.403
AP Gurusinha (1985-1996),147,49,49,0,2,47,2 (2ct 0st),0.333
RP Arnold (1997-2007),179,48,48,0,0,48,2 (2ct 0st),0.268
AD Mathews (2008-2018),192,48,48,0,0,48,3 (3ct 0st),0.250
WU Tharanga (2005-2018),215,48,48,0,0,48,3 (3ct 0st),0.223
KMDN Kulasekara (2003-2017),181,46,46,0,0,46,3 (3ct 0st),0.254
DSBP Kuruppu (1983-1990),54,38,30,8,26,4,4 (3ct 1st),0.703
HDRL Thirimanne (2010-2017),115,37,37,0,0,37,2 (2ct 0st),0.321
HDPK Dharmasena (1994-2004),140,34,34,0,0,34,2 (2ct 0st),0.242
N Dickwella (2014-2018),36,34,28,6,28,0,3 (2ct 1st),0.944
RS Kalpage (1992-1999),86,33,33,0,0,33,3 (3ct 0st),0.383
CK Kapugedera (2006-2017),100,31,31,0,0,31,2 (2ct 0st),0.310
RG de Alwis (1983-1988),31,30,27,3,27,0,5 (5ct 0st),0.967
SL Malinga (2004-2017),198,29,29,0,0,29,2 (2ct 0st),0.146
MDKJ Perera (2013-2018),72,29,27,2,12,15,4 (4ct 0st),0.402
CRD Fernando (2001-2012),145,27,27,0,0,27,3 (3ct 0st),0.186
MF Maharoof (2004-2016),107,26,26,0,0,26,2 (2ct 0st),0.242
GP Wickramasinghe (1990-2002),134,26,26,0,0,26,2 (2ct 0st),0.194
BKG Mendis (2016-2018),43,23,23,0,0,23,2 (2ct 0st),0.534
LPC Silva (1999-2011),73,20,20,0,0,20,3 (3ct 0st),0.273
SAR Silva (1984-1985),20,20,17,3,17,0,3 (3ct 0st),1.000
SMSM Senanayake (2012-2015),48,19,19,0,0,19,3 (3ct 0st),0.395
RS Madugalle (1979-1988),63,18,18,0,0,18,2 (2ct 0st),0.285
TT Samaraweera (1998-2011),51,17,17,0,0,17,2 (2ct 0st),0.333
RL Dias (1979-1987),58,16,16,0,0,16,2 (2ct 0st),0.275
SKL de Silva (1997-1997),11,15,9,6,9,0,3 (3ct 0st),1.363
BAW Mendis (2008-2015),85,15,15,0,0,15,2 (2ct 0st),0.176
HMRKB Herath (2004-2015),69,14,14,0,0,14,2 (2ct 0st),0.202
RAS Lakmal (2009-2018),73,14,14,0,0,14,1 (1ct 0st),0.191
LRD Mendis (1975-1989),79,14,14,0,0,14,2 (2ct 0st),0.177
JR Ratnayeke (1982-1990),78,14,14,0,0,14,2 (2ct 0st),0.179
PB Dassanayake (1993-1994),16,13,9,4,9,0,2 (2ct 0st),0.812
ALF de Mel (1982-1987),57,13,13,0,0,13,2 (2ct 0st),0.228
DA Gunawardene (1998-2006),61,13,13,0,0,13,2 (2ct 0st),0.213
BMAJ Mendis (2010-2015),52,13,13,0,0,13,2 (2ct 0st),0.250
DNT Zoysa (1997-2007),94,13,13,0,0,13,2 (2ct 0st),0.138
KSC de Silva (1996-2000),37,12,12,0,0,12,2 (2ct 0st),0.324
MD Gunathilaka (2015-2018),32,12,12,0,0,12,2 (2ct 0st),0.375
J Mubarak (2002-2013),40,12,12,0,0,12,2 (2ct 0st),0.300
CPH Ramanayake (1986-1995),62,11,11,0,0,11,2 (2ct 0st),0.177
RJ Ratnayake (1982-1993),70,11,11,0,0,11,2 (2ct 0st),0.157
SD Anurasiri (1986-1994),45,10,10,0,0,10,2 (2ct 0st),0.222
DAS Gunaratne (2016-2018),28,10,10,0,0,10,2 (2ct 0st),0.357
HMCM Bandara (2006-2010),30,9,9,0,0,9,3 (3ct 0st),0.300
SI de Saram (1999-2001),15,9,9,0,0,9,2 (2ct 0st),0.600
DM de Silva (2016-2017),17,8,8,0,0,8,2 (2ct 0st),0.470
GF Labrooy (1986-1992),44,8,8,0,0,8,1 (1ct 0st),0.181
KR Pushpakumara (1994-1999),31,8,8,0,0,8,3 (3ct 0st),0.258
A Dananjaya (2012-2018),18,7,7,0,0,7,2 (2ct 0st),0.388
S Randiv (2009-2016),30,7,7,0,0,7,1 (1ct 0st),0.233
SHT Kandamby (2004-2014),38,7,7,0,0,7,2 (2ct 0st),0.184
SMA Priyanjan (2013-2015),23,7,7,0,0,7,1 (1ct 0st),0.304
AM de Silva (1986-1993),4,6,4,2,4,0,3 (2ct 1st),1.500
EAR de Silva (1986-1992),28,6,6,0,0,6,2 (2ct 0st),0.214
N Pradeep (2012-2018),27,6,6,0,0,6,2 (2ct 0st),0.222
UC Hathurusingha (1992-1999),35,6,6,0,0,6,1 (1ct 0st),0.171
DK Liyanage (1992-2001),16,6,6,0,0,6,2 (2ct 0st),0.375
S Prasanna (2011-2017),38,6,6,0,0,6,1 (1ct 0st),0.157
AGD Wickremasinghe (1992-1993),4,6,2,4,2,0,3 (1ct 2st),1.500
DS de Silva (1975-1985),41,5,5,0,0,5,1 (1ct 0st),0.121
RMS Eranga (2011-2016),18,5,5,0,0,5,2 (2ct 0st),0.277
WS Jayantha (2004-2004),17,5,5,0,0,5,1 (1ct 0st),0.294
HAPW Jayawardene (2003-2007),6,5,4,1,4,0,2 (2ct 0st),0.833
VB John (1982-1987),45,5,5,0,0,5,1 (1ct 0st),0.111
KS Lokuarachchi (2003-2007),21,5,5,0,0,5,1 (1ct 0st),0.238
MAR Samarasekera (1983-1994),39,5,5,0,0,5,2 (2ct 0st),0.128
TAM Siriwardana (2015-2017),25,5,5,0,0,5,2 (2ct 0st),0.200
B Warnapura (1975-1982),12,5,5,0,0,5,2 (2ct 0st),0.416
PVD Chameera (2015-2018),20,4,4,0,0,4,1 (1ct 0st),0.200
PC de Silva (2014-2017),7,4,4,0,0,4,2 (2ct 0st),0.571
PWH de Silva (2017-2018),9,4,4,0,0,4,2 (2ct 0st),0.444
HM Goonatilleke (1982-1982),6,4,0,4,0,0,2 (0ct 2st),0.666
FDM Karunaratne (2011-2015),17,4,4,0,0,4,1 (1ct 0st),0.235
SS Pathirana (2015-2017),18,4,4,0,0,4,2 (2ct 0st),0.222
ASA Perera (1998-2001),20,4,4,0,0,4,2 (2ct 0st),0.200
T Thushara (2008-2010),38,4,4,0,0,4,1 (1ct 0st),0.105
LHD Dilhara (2005-2013),9,3,3,0,0,3,1 (1ct 0st),0.333
TCB Fernando (2001-2003),17,3,3,0,0,3,2 (2ct 0st),0.176
PW Gunaratne (2002-2003),23,3,3,0,0,3,1 (1ct 0st),0.130
MAWR Madurasinghe (1988-1992),12,3,3,0,0,3,1 (1ct 0st),0.250
RAP Nissanka (2001-2003),23,3,3,0,0,3,1 (1ct 0st),0.130
ARM Opatha (1975-1979),5,3,3,0,0,3,2 (2ct 0st),0.600
DP Samaraweera (1993-1994),5,3,3,0,0,3,2 (2ct 0st),0.600
PADLR Sandakan (2016-2018),12,3,3,0,0,3,2 (2ct 0st),0.250
APB Tennekoon (1975-1979),4,3,3,0,0,3,1 (1ct 0st),0.750
SM Warnapura (2007-2008),3,3,3,0,0,3,2 (2ct 0st),1.000
K Weeraratne (2000-2008),15,3,3,0,0,3,1 (1ct 0st),0.200
S Wettimuny (1982-1987),35,3,3,0,0,3,1 (1ct 0st),0.085
KIW Wijegunawardene (1988-1992),26,3,3,0,0,3,1 (1ct 0st),0.115
GRA de Silva (1975-1982),6,2,2,0,0,2,1 (1ct 0st),0.333
CI Dunusinghe (1995-1995),1,2,1,1,1,0,2 (1ct 1st),2.000
KHRK Fernando (2002-2006),7,2,2,0,0,2,1 (1ct 0st),0.285
D Gamage (2003-2003),3,2,2,0,0,2,1 (1ct 0st),0.666
JC Gamage (1995-1995),4,2,2,0,0,2,1 (1ct 0st),0.500
PLS Gamage (2014-2017),9,2,2,0,0,2,1 (1ct 0st),0.222
SMS Kaluperuma (1988-1988),2,2,2,0,0,2,1 (1ct 0st),1.000
MC Mendis (1995-1995),1,2,2,0,0,2,2 (2ct 0st),2.000
EMDY Munaweera (2017-2017),2,2,2,0,0,2,1 (1ct 0st),1.000
MDK Perera (2007-2017),11,2,2,0,0,2,1 (1ct 0st),0.181
PDRL Perera (1999-2007),19,2,2,0,0,2,1 (1ct 0st),0.105
PM Pushpakumara (2017-2017),2,2,2,0,0,2,1 (1ct 0st),1.000
S Ranatunga (1994-1996),13,2,2,0,0,2,1 (1ct 0st),0.153
CP Senanayake (1990-1991),7,2,2,0,0,2,1 (1ct 0st),0.285
MD Shanaka (2016-2016),9,2,2,0,0,2,1 (1ct 0st),0.222
KEA Upashantha (1995-2001),12,2,2,0,0,2,1 (1ct 0st),0.166
KDK Vithanage (2013-2014),6,2,2,0,0,2,1 (1ct 0st),0.333
KPJ Warnaweera (1990-1993),6,2,2,0,0,2,1 (1ct 0st),0.333
DS Weerakkody (2017-2017),3,2,2,0,0,2,1 (1ct 0st),0.666
UWMBCA Welegedara (2009-2010),9,2,2,0,0,2,1 (1ct 0st),0.222
RGCE Wijesuriya (1982-1985),8,2,2,0,0,2,1 (1ct 0st),0.250
MKDI Amerasinghe (2007-2008),8,1,1,0,0,1,1 (1ct 0st),0.125
JWHD Boteju (1999-1999),2,1,1,0,0,1,1 (1ct 0st),0.500
DLS de Silva (1979-1979),2,1,1,0,0,1,1 (1ct 0st),0.500
KADM Fernando (2003-2003),1,1,1,0,0,1,1 (1ct 0st),1.000
WCA Ganegama (2001-2006),4,1,1,0,0,1,1 (1ct 0st),0.250
PD Heyn (1975-1975),2,1,1,0,0,1,1 (1ct 0st),0.500
SA Jayasinghe (1979-1979),2,1,1,0,1,0,1 (1ct 0st),0.500
GSNFG Jayasuriya (2015-2016),6,1,1,0,0,1,1 (1ct 0st),0.166
S Jeganathan (1983-1988),5,1,1,0,0,1,1 (1ct 0st),0.200
SHU Karnain (1984-1990),19,1,1,0,0,1,1 (1ct 0st),0.052
CKB Kulasekara (2011-2012),4,1,1,0,0,1,1 (1ct 0st),0.250
CBRLS Kumara (2017-2017),4,1,1,0,0,1,1 (1ct 0st),0.250
AK Perera (2013-2016),4,1,1,0,0,1,1 (1ct 0st),0.250
KTGD Prasad (2006-2015),24,1,1,0,0,1,1 (1ct 0st),0.041
SK Ranasinghe (1986-1986),4,1,1,0,0,1,1 (1ct 0st),0.250
D Ranatunga (1990-1990),4,1,1,0,0,1,1 (1ct 0st),0.250
JDF Vandersay (2015-2017),11,1,1,0,0,1,1 (1ct 0st),0.090
FS Ahangama (1985-1985),1,0,0,0,0,0,0,0.000
KN Amalean (1986-1988),8,0,0,0,0,0,0,0.000
MA Aponso (2016-2017),6,0,0,0,0,0,0,0.000
KMC Bandara (2016-2016),1,0,0,0,0,0,0,0.000
MRCN Bandaratilleke (1998-1998),3,0,0,0,0,0,0,0.000
GN de Silva (1983-1985),4,0,0,0,0,0,0,0.000
AM Fernando (2017-2017),1,0,0,0,0,0,0,0.000
ER Fernando (1975-1975),3,0,0,0,0,0,0,0.000
ERNS Fernando (1983-1983),7,0,0,0,0,0,0,0.000
MVT Fernando (2017-2017),6,0,0,0,0,0,0,0.000
TL Fernando (1989-1989),1,0,0,0,0,0,0,0.000
UNK Fernando (1994-1994),2,0,0,0,0,0,0,0.000
WIA Fernando (2016-2016),1,0,0,0,0,0,0,0.000
IS Gallage (1999-2001),3,0,0,0,0,0,0,0.000
Y Goonasekera (1983-1983),3,0,0,0,0,0,0,0.000
FRMD Gunatilleke (1979-1979),1,0,0,0,0,0,0,0.000
AAW Gunawardena (1994-1994),1,0,0,0,0,0,0,0.000
PS Jayaprakashdaran (2005-2005),1,0,0,0,0,0,0,0.000
RSA Jayasekera (1982-1982),2,0,0,0,0,0,0,0.000
LWS Kaluperuma (1975-1982),4,0,0,0,0,0,0,0.000
PHT Kaushal (2015-2015),1,0,0,0,0,0,0,0.000
MKGCP Lakshitha (2002-2003),7,0,0,0,0,0,0,0.000
DSK Madushanka (2018-2018),1,0,0,0,0,0,0,0.000
LD Madushanka (2017-2017),4,0,0,0,0,0,0,0.000
AMN Munasinghe (1994-1996),5,0,0,0,0,0,0,0.000
MN Nawaz (1998-2002),3,0,0,0,0,0,0,0.000
SP Pasqual (1979-1979),2,0,0,0,0,0,0,0.000
KG Perera (1986-1986),1,0,0,0,0,0,0,0.000
HSM Pieris (1975-1975),3,0,0,0,0,0,0,0.000
M Pushpakumara (2009-2010),2,0,0,0,0,0,0,0.000
AN Ranasinghe (1975-1982),9,0,0,0,0,0,0,0.000
N Ranatunga (1993-1993),2,0,0,0,0,0,0,0.000
NLK Ratnayake (1989-1990),2,0,0,0,0,0,0,0.000
S Samarawickrama (2017-2017),3,0,0,0,0,0,0,0.000
KJ Silva (1995-1995),1,0,0,0,0,0,0,0.000
MH Tissera (1975-1975),3,0,0,0,0,0,0,0.000
I Udana (2012-2012),2,0,0,0,0,0,0,0.000
ML Udawatte (2008-2008),9,0,0,0,0,0,0,0.000
MG Vandort (2006-2006),1,0,0,0,0,0,0,0.000
DM Vonhagt (1985-1985),1,0,0,0,0,0,0,0.000
AP Weerakkody (1994-1994),1,0,0,0,0,0,0,0.000
S Weerakoon (2012-2012),2,0,0,0,0,0,0,0.000
MD Wettimuny (1983-1983),1,0,0,0,0,0,0,0.000
SRD Wettimuny (1975-1979),3,0,0,0,0,0,0,0.000
RPAH Wickramaratne (1993-1993),3,0,0,0,0,0,0,0.000
A Flower (1992-2003),212,173,141,32,133,8,5 (5ct 0st),0.816
T Taibu (2001-2012),149,147,114,33,112,2,4 (4ct 0st),0.986
BRM Taylor (2004-2018),182,136,109,27,80,29,4 (4ct 0st),0.747
GW Flower (1992-2010),220,86,86,0,0,86,2 (2ct 0st),0.390
ADR Campbell (1992-2003),187,76,76,0,2,74,3 (3ct 0st),0.406
H Masakadza (2001-2018),193,70,70,0,0,70,2 (2ct 0st),0.362
E Chigumbura (2004-2016),201,69,69,0,0,69,4 (4ct 0st),0.343
P Utseya (2004-2015),164,50,50,0,0,50,2 (2ct 0st),0.304
HH Streak (1993-2005),186,45,45,0,0,45,2 (2ct 0st),0.241
V Sibanda (2003-2016),125,42,42,0,0,42,2 (2ct 0st),0.336
SC Williams (2005-2018),115,42,42,0,0,42,2 (2ct 0st),0.365
SV Carlisle (1995-2005),111,39,39,0,0,39,3 (3ct 0st),0.351
AG Cremer (2009-2018),95,37,37,0,0,37,2 (2ct 0st),0.389
CR Ervine (2010-2018),79,37,37,0,0,37,4 (4ct 0st),0.468
S Matsikenyeri (2002-2015),113,37,37,0,0,37,3 (3ct 0st),0.327
Sikandar Raza (2013-2018),84,36,36,0,0,36,3 (3ct 0st),0.428
GJ Whittall (1993-2003),146,36,36,0,0,36,4 (4ct 0st),0.246
CJ Chibhabha (2005-2016),99,32,32,0,0,32,2 (2ct 0st),0.323
DL Houghton (1983-1997),63,31,29,2,10,19,4 (4ct 0st),0.492
PA Strang (1994-2001),94,30,30,0,0,30,2 (2ct 0st),0.319
R Mutumbami (2014-2016),31,26,21,5,21,0,4 (4ct 0st),0.838
CB Wishart (1996-2005),90,26,26,0,0,26,2 (2ct 0st),0.288
RW Chakabva (2008-2015),34,23,20,3,8,12,4 (4ct 0st),0.676
DD Ebrahim (2001-2005),82,23,23,0,0,23,2 (2ct 0st),0.280
MN Waller (2009-2018),79,22,22,0,0,22,1 (1ct 0st),0.278
AR Whittall (1996-2000),63,21,21,0,0,21,3 (3ct 0st),0.333
GB Brent (1996-2008),70,20,20,0,0,20,2 (2ct 0st),0.285
CK Coventry (2003-2015),39,20,19,1,0,19,1 (1ct 0st),0.512
MW Goodwin (1998-2000),71,20,20,0,0,20,2 (2ct 0st),0.281
NC Johnson (1998-2000),48,19,19,0,0,19,2 (2ct 0st),0.395
PJ Moor (2014-2018),30,19,18,1,16,2,4 (4ct 0st),0.633
MA Vermeulen (2000-2009),43,18,18,0,0,18,3 (3ct 0st),0.418
DP Viljoen (1997-2001),53,18,18,0,0,18,2 (2ct 0st),0.339
TJ Friend (2000-2004),51,17,17,0,0,17,2 (2ct 0st),0.333
RW Price (2002-2012),102,17,17,0,0,17,2 (2ct 0st),0.166
GJ Rennie (1996-2003),40,16,16,0,0,16,2 (2ct 0st),0.400
DT Hondo (2001-2005),56,15,15,0,0,15,1 (1ct 0st),0.267
BC Strang (1995-2001),48,15,15,0,0,15,2 (2ct 0st),0.312
HK Olonga (1995-2003),50,13,13,0,0,13,2 (2ct 0st),0.260
KM Dabengwa (2005-2010),37,12,12,0,0,12,2 (2ct 0st),0.324
CN Evans (1992-2002),52,12,12,0,0,12,2 (2ct 0st),0.230
DA Marillier (2000-2003),48,12,12,0,0,12,2 (2ct 0st),0.250
JA Rennie (1993-2000),44,12,12,0,0,12,2 (2ct 0st),0.272
AM Blignaut (1999-2010),54,11,11,0,0,11,2 (2ct 0st),0.203
EA Brandes (1987-1999),59,11,11,0,0,11,1 (1ct 0st),0.186
CB Mpofu (2004-2017),78,11,11,0,0,11,1 (1ct 0st),0.141
BA Murphy (2000-2003),31,11,11,0,0,11,2 (2ct 0st),0.354
F Mutizwa (2009-2011),17,11,9,2,8,1,3 (3ct 0st),0.647
LM Jongwe (2014-2016),22,10,10,0,0,10,3 (3ct 0st),0.454
SF Mire (2014-2018),37,10,10,0,0,10,1 (1ct 0st),0.270
AC Waller (1987-1997),38,10,10,0,0,10,2 (2ct 0st),0.263
T Mupariwa (2004-2016),40,9,9,0,0,9,1 (1ct 0st),0.225
T Panyangara (2004-2016),65,9,9,0,0,9,2 (2ct 0st),0.138
KM Jarvis (2009-2018),34,8,8,0,0,8,2 (2ct 0st),0.235
T Maruma (2007-2016),17,8,8,0,0,8,2 (2ct 0st),0.470
TK Musakanda (2016-2018),11,8,8,0,0,8,2 (2ct 0st),0.727
EC Rainsford (2004-2010),39,8,8,0,0,8,2 (2ct 0st),0.205
AG Huckle (1997-1999),19,7,7,0,0,7,2 (2ct 0st),0.368
SW Masakadza (2010-2014),16,7,7,0,0,7,3 (3ct 0st),0.437
B Muzarabani (2018-2018),14,7,7,0,0,7,2 (2ct 0st),0.500
J Nyumbu (2014-2015),19,7,7,0,0,7,2 (2ct 0st),0.368
BG Rogers (2002-2005),15,7,7,0,0,7,1 (1ct 0st),0.466
RP Burl (2017-2018),13,6,6,0,0,6,2 (2ct 0st),0.461
TS Chisoro (2015-2018),15,6,6,0,0,6,2 (2ct 0st),0.400
T Duffin (2006-2007),23,6,6,0,0,6,1 (1ct 0st),0.260
WR James (1992-1996),11,6,6,0,3,3,2 (2ct 0st),0.545
TP Kamungozi (2006-2015),14,6,6,0,0,6,2 (2ct 0st),0.428
NB Mahwire (2004-2006),23,6,6,0,0,6,2 (2ct 0st),0.260
ML Nkala (1998-2006),50,6,6,0,0,6,1 (1ct 0st),0.120
AH Omarshah (1983-1996),28,6,6,0,0,6,2 (2ct 0st),0.214
AJ Pycroft (1983-1992),20,6,6,0,0,6,2 (2ct 0st),0.300
DH Brain (1992-1995),23,5,5,0,0,5,2 (2ct 0st),0.217
RD Brown (1983-1987),7,5,5,0,0,5,2 (2ct 0st),0.714
TL Chatara (2013-2018),54,5,5,0,0,5,1 (1ct 0st),0.092
MH Dekker (1992-1996),23,5,5,0,0,5,1 (1ct 0st),0.217
SM Ervine (2001-2004),42,5,5,0,0,5,1 (1ct 0st),0.119
RS Higgins (2006-2006),11,5,5,0,0,5,1 (1ct 0st),0.454
IP Butchart (1983-1995),20,4,4,0,0,4,1 (1ct 0st),0.200
TR Gripper (2001-2003),8,4,4,0,0,4,2 (2ct 0st),0.500
WP Masakadza (2015-2015),10,4,4,0,0,4,2 (2ct 0st),0.400
CT Mutombodzi (2013-2015),11,4,4,0,0,4,2 (2ct 0st),0.363
PWE Rawson (1983-1987),10,4,4,0,0,4,2 (2ct 0st),0.400
GM Strydom (2006-2006),12,4,4,0,0,4,2 (2ct 0st),0.333
BV Vitori (2011-2018),24,4,4,0,0,4,1 (1ct 0st),0.166
KJ Arnott (1987-1993),13,3,3,0,0,3,1 (1ct 0st),0.230
BB Chari (2015-2016),7,3,2,1,1,1,2 (1ct 1st),0.428
GM Ewing (2004-2005),7,3,3,0,0,3,2 (2ct 0st),0.428
N Madziva (2014-2016),12,3,3,0,0,3,1 (1ct 0st),0.250
M Mbangwa (1996-2002),29,3,3,0,0,3,1 (1ct 0st),0.103
AJ Traicos (1983-1993),27,3,3,0,0,3,1 (1ct 0st),0.111
MG Burmester (1992-1995),8,2,2,0,0,2,1 (1ct 0st),0.250
KG Duers (1992-1992),6,2,2,0,0,2,1 (1ct 0st),0.333
EA Essop-Adam (1992-1992),1,2,2,0,0,2,2 (2ct 0st),2.000
AJ Ireland (2005-2007),26,2,2,0,0,2,1 (1ct 0st),0.076
TN Madondo (1998-2001),13,2,2,0,0,2,1 (1ct 0st),0.153
A Maregwede (2003-2005),11,2,2,0,0,2,1 (1ct 0st),0.181
TMK Mawoyo (2006-2014),7,2,2,0,0,2,1 (1ct 0st),0.285
W Mwayenga (2002-2004),3,2,2,0,0,2,1 (1ct 0st),0.666
GA Paterson (1983-1987),10,2,2,0,0,2,1 (1ct 0st),0.200
GJ Crocker (1992-1993),6,1,1,0,0,1,1 (1ct 0st),0.166
KM Curran (1983-1987),11,1,1,0,0,1,1 (1ct 0st),0.090
TN Garwe (2009-2009),1,1,1,0,0,1,1 (1ct 0st),1.000
JG Heron (1983-1983),6,1,1,0,0,1,1 (1ct 0st),0.166
MP Jarvis (1987-1995),12,1,1,0,0,1,1 (1ct 0st),0.083
ACI Lock (1996-1996),7,1,1,0,0,1,1 (1ct 0st),0.142
AJ Mackay (2001-2001),3,1,1,0,0,1,1 (1ct 0st),0.333
EZ Matambanadzo (1996-1997),7,1,1,0,0,1,1 (1ct 0st),0.142
KO Meth (2006-2012),11,1,1,0,0,1,1 (1ct 0st),0.090
TV Mufambisi (2006-2007),6,1,1,0,1,0,1 (1ct 0st),0.166
CT Mumba (2016-2017),2,1,1,0,0,1,1 (1ct 0st),0.500
"N M'shangwe (2011-2014)",6,1,1,0,0,1,1 (1ct 0st),0.166
DT Mutendera (1999-2001),9,1,1,0,0,1,1 (1ct 0st),0.111
R Ngarava (2017-2017),6,1,1,0,0,1,1 (1ct 0st),0.166
SG Peall (1992-1996),20,1,1,0,0,1,1 (1ct 0st),0.050
U Ranchod (1992-1993),3,1,1,0,0,1,1 (1ct 0st),0.333
RW Sims (2002-2003),3,1,1,0,0,1,1 (1ct 0st),0.333
GA Briant (1993-1993),5,0,0,0,0,0,0,0.000
GK Bruk-Jackson (1993-1993),1,0,0,0,0,0,0,0.000
MT Chinouya (2013-2013),2,0,0,0,0,0,0,0.000
SG Davies (1996-1996),4,0,0,0,0,0,0,0.000
DAG Fletcher (1983-1983),6,0,0,0,0,0,0,0.000
VR Hogg (1983-1983),2,0,0,0,0,0,0,0.000
R Kaia (2015-2015),1,0,0,0,0,0,0,0.000
F Kasteni (2007-2007),3,0,0,0,0,0,0,0.000
GA Lamb (2010-2011),15,0,0,0,0,0,0,0.000
GC Martin (1994-1995),5,0,0,0,0,0,0,0.000
MA Meman (1987-1987),1,0,0,0,0,0,0,0.000
T Muzarabani (2015-2016),8,0,0,0,0,0,0,0.000
N Ncube (2011-2011),1,0,0,0,0,0,0,0.000
IA Nicolson (2010-2010),2,0,0,0,0,0,0,0.000
GE Peckover (1983-1983),3,0,0,0,0,0,0,0.000
HP Rinke (2006-2006),18,0,0,0,0,0,0,0.000
DT Tiripano (2014-2017),14,0,0,0,0,0,0,0.000
C Zhuwao (2008-2018),6,0,0,0,0,0,0,0.000
Mushfiqur Rahim (2006-2018),183,187,146,41,144,2,5 (5ct 0st),1.021
Khaled Mashud (1995-2006),126,126,91,35,91,0,5 (3ct 2st),1.000
Mashrafe Mortaza (2001-2018),185,55,55,0,0,55,2 (2ct 0st),0.297
Mahmudullah (2007-2018),152,52,52,0,0,52,3 (3ct 0st),0.342
Shakib Al Hasan (2006-2018),184,43,43,0,0,43,3 (3ct 0st),0.233
Tamim Iqbal (2007-2018),178,43,43,0,0,43,2 (2ct 0st),0.241
Mohammad Ashraful (2001-2013),175,35,35,0,0,35,2 (2ct 0st),0.200
Nasir Hossain (2011-2018),65,34,34,0,0,34,2 (2ct 0st),0.523
Abdur Razzak (2004-2014),153,32,32,0,0,32,2 (2ct 0st),0.209
Aftab Ahmed (2004-2010),85,29,29,0,0,29,3 (3ct 0st),0.341
Alok Kapali (2002-2011),69,29,29,0,0,29,2 (2ct 0st),0.420
Sabbir Rahman (2014-2018),50,29,29,0,0,29,3 (3ct 0st),0.580
Mohammad Rafique (1995-2007),123,28,28,0,0,28,2 (2ct 0st),0.227
Habibul Bashar (1995-2007),111,26,26,0,0,26,2 (2ct 0st),0.234
Junaid Siddique (2007-2011),54,23,23,0,1,22,3 (3ct 0st),0.425
Imrul Kayes (2008-2017),70,21,21,0,0,21,2 (2ct 0st),0.300
Naeem Islam (2008-2014),59,19,19,0,0,19,2 (2ct 0st),0.322
Raqibul Hasan (2008-2011),55,18,18,0,0,18,2 (2ct 0st),0.327
Khaled Mahmud (1998-2006),77,17,17,0,0,17,2 (2ct 0st),0.220
Soumya Sarkar (2014-2017),31,15,15,0,0,15,4 (4ct 0st),0.483
Aminul Islam (1988-2002),39,13,13,0,0,13,2 (2ct 0st),0.333
Dhiman Ghosh (2008-2008),14,13,9,4,9,0,4 (4ct 0st),0.928
Farhad Reza (2006-2011),34,13,13,0,0,13,2 (2ct 0st),0.382
Rubel Hossain (2009-2018),84,13,13,0,0,13,2 (2ct 0st),0.154
Shahriar Nafees (2005-2011),75,13,13,0,0,13,2 (2ct 0st),0.173
Javed Omar (1995-2007),59,12,12,0,0,12,2 (2ct 0st),0.203
Sanwar Hossain (1998-2003),27,11,11,0,0,11,2 (2ct 0st),0.407
Anamul Haque (2012-2018),34,10,10,0,6,4,3 (3ct 0st),0.294
Liton Das (2015-2017),12,9,9,0,6,3,4 (4ct 0st),0.750
Rajin Saleh (2003-2006),43,9,9,0,0,9,2 (2ct 0st),0.209
Sohrawordi Shuvo (2010-2011),17,9,9,0,0,9,2 (2ct 0st),0.529
Akram Khan (1988-2003),44,8,8,0,0,8,2 (2ct 0st),0.181
Enamul Haque jnr (2005-2009),10,8,8,0,0,8,2 (2ct 0st),0.800
Hannan Sarkar (2002-2004),20,8,8,0,2,6,2 (2ct 0st),0.400
Manjural Islam (1999-2003),34,8,8,0,0,8,1 (1ct 0st),0.235
Mosaddek Hossain (2016-2017),17,8,8,0,0,8,2 (2ct 0st),0.470
Shafiul Islam (2010-2016),56,8,8,0,0,8,2 (2ct 0st),0.142
Syed Rasel (2005-2010),52,8,8,0,0,8,2 (2ct 0st),0.153
Tapash Baisya (2002-2007),56,8,8,0,0,8,1 (1ct 0st),0.142
Al Sahariar (1999-2003),29,7,7,0,0,7,2 (2ct 0st),0.241
Jahurul Islam (2010-2013),14,7,7,0,4,3,3 (3ct 0st),0.500
Mehrab Hossain jnr (2006-2009),18,7,7,0,0,7,1 (1ct 0st),0.388
Naimur Rahman (1995-2002),29,7,7,0,0,7,2 (2ct 0st),0.241
Sohag Gazi (2012-2014),20,7,7,0,0,7,2 (2ct 0st),0.350
Taskin Ahmed (2014-2017),31,7,7,0,0,7,1 (1ct 0st),0.225
Enamul Haque (1990-2002),29,6,6,0,0,6,3 (3ct 0st),0.206
Hasibul Hossain (1995-2004),32,6,6,0,0,6,2 (2ct 0st),0.187
Manjural Islam Rana (2003-2006),25,6,6,0,0,6,1 (1ct 0st),0.240
Mehrab Hossain (1998-2003),18,6,6,0,0,6,2 (2ct 0st),0.333
Mushfiqur Rahman (2000-2004),28,6,6,0,0,6,1 (1ct 0st),0.214
Mustafizur Rahman (2015-2018),26,6,6,0,0,6,2 (2ct 0st),0.230
Nazmul Hossain (2004-2012),38,6,6,0,0,6,1 (1ct 0st),0.157
Tushar Imran (2001-2007),41,6,6,0,0,6,1 (1ct 0st),0.146
Arafat Sunny (2014-2015),16,5,5,0,0,5,1 (1ct 0st),0.312
Shahadat Hossain (2006-2013),51,5,5,0,0,5,1 (1ct 0st),0.098
Shahriar Hossain (1997-2004),20,5,5,0,0,5,1 (1ct 0st),0.250
Ziaur Rahman (2013-2014),13,5,5,0,0,5,1 (1ct 0st),0.384
Mominul Haque (2012-2015),26,4,4,0,0,4,1 (1ct 0st),0.153
Tareq Aziz (2002-2004),10,4,4,0,0,4,1 (1ct 0st),0.400
Faisal Hossain (2004-2010),6,3,3,0,0,3,1 (1ct 0st),0.500
Nurul Hasan (2016-2016),2,3,2,1,2,0,3 (2ct 1st),1.500
Shamsur Rahman (2013-2014),10,3,3,0,0,3,2 (2ct 0st),0.300
Athar Ali Khan (1988-1998),19,2,2,0,0,2,1 (1ct 0st),0.105
Azhar Hossain (1988-1990),7,2,2,0,0,2,1 (1ct 0st),0.285
Fahim Muntasir (2001-2002),3,2,2,0,0,2,1 (1ct 0st),0.666
Faruk Ahmed (1988-1999),7,2,2,0,0,2,1 (1ct 0st),0.285
Hafizur Rahman (1986-1986),2,2,2,0,2,0,1 (1ct 0st),1.000
Minhajul Abedin (1986-1999),27,2,2,0,0,2,1 (1ct 0st),0.074
Morshed Ali Khan (1998-1998),3,2,2,0,0,2,1 (1ct 0st),0.666
Nafees Iqbal (2003-2005),16,2,2,0,0,2,1 (1ct 0st),0.125
Nasir Ahmed (1988-1990),7,2,1,1,1,0,1 (1ct 0st),0.285
Abul Hasan (2012-2018),7,1,1,0,0,1,1 (1ct 0st),0.142
Al-Amin Hossain (2014-2015),14,1,1,0,0,1,1 (1ct 0st),0.071
Gazi Ashraf (1986-1990),7,1,1,0,0,1,1 (1ct 0st),0.142
Jahangir Alam (1997-1999),3,1,0,1,0,0,1 (0ct 1st),0.333
Jahangir Shah (1986-1990),5,1,1,0,0,1,1 (1ct 0st),0.200
Jamaluddin Ahmed (2003-2003),1,1,1,0,0,1,1 (1ct 0st),1.000
Jubair Hossain (2014-2015),3,1,1,0,0,1,1 (1ct 0st),0.333
Mafizur Rahman (1997-1997),4,1,1,0,0,1,1 (1ct 0st),0.250
Mahbubul Alam (2009-2009),5,1,1,0,0,1,1 (1ct 0st),0.200
Mehidy Hasan Miraz (2017-2018),7,1,1,0,0,1,1 (1ct 0st),0.142
Mohammad Mithun (2014-2018),3,1,1,0,0,1,1 (1ct 0st),0.333
Mohammad Saifuddin (2017-2018),3,1,1,0,0,1,1 (1ct 0st),0.333
Mohammad Salim (2003-2003),1,1,1,0,1,0,1 (1ct 0st),1.000
Mohammad Sharif (2001-2007),9,1,1,0,0,1,1 (1ct 0st),0.111
Mosharraf Hossain (2008-2016),5,1,1,0,0,1,1 (1ct 0st),0.200
Nazimuddin (2008-2012),11,1,1,0,0,1,1 (1ct 0st),0.090
Neeyamur Rashid (1999-1999),2,1,1,0,0,1,1 (1ct 0st),0.500
Raqibul Hasan (1986-1986),2,1,1,0,0,1,1 (1ct 0st),0.500
Samiur Rahman (1986-1986),2,1,1,0,0,1,1 (1ct 0st),0.500
Taijul Islam (2014-2016),4,1,1,0,0,1,1 (1ct 0st),0.250
Talha Jubair (2002-2003),6,1,1,0,0,1,1 (1ct 0st),0.166
Tanbir Hayder (2016-2016),2,1,1,0,0,1,1 (1ct 0st),0.500
Ahmed Kamal (1999-1999),1,0,0,0,0,0,0,0.000
Aminul Islam jnr (1999-1999),1,0,0,0,0,0,0,0.000
Anisur Rahman (1995-1998),2,0,0,0,0,0,0,0.000
Anwar Hossain (2002-2002),1,0,0,0,0,0,0,0.000
Anwar Hossain Monir (2002-2002),1,0,0,0,0,0,0,0.000
Dolar Mahmud (2008-2009),7,0,0,0,0,0,0,0.000
Ehsanul Haque (2002-2003),6,0,0,0,0,0,0,0.000
Elias Sunny (2011-2012),4,0,0,0,0,0,0,0.000
Gholam Nousher (1986-1990),9,0,0,0,0,0,0,0.000
Golam Faruq (1986-1990),5,0,0,0,0,0,0,0.000
Harunur Rashid (1988-1988),2,0,0,0,0,0,0,0.000
Jahangir Alam Talukdar (1990-1990),2,0,0,0,0,0,0,0.000
Mahbubur Rahman (1999-1999),1,0,0,0,0,0,0,0.000
Mazharul Haque (2002-2002),1,0,0,0,0,0,0,0.000
Moniruzzaman (2003-2003),2,0,0,0,0,0,0,0.000
Nurul Abedin (1986-1990),4,0,0,0,0,0,0,0.000
Rafiqul Alam (1986-1986),2,0,0,0,0,0,0,0.000
Rafiqul Islam (2002-2002),1,0,0,0,0,0,0,0.000
Robiul Islam (2013-2013),3,0,0,0,0,0,0,0.000
Saiful Islam (1990-1997),7,0,0,0,0,0,0,0.000
Sajjad Ahmed (1995-1995),2,0,0,0,0,0,0,0.000
Shafiuddin Ahmed (1997-2000),11,0,0,0,0,0,0,0.000
Shaheedur Rahman (1986-1986),2,0,0,0,0,0,0,0.000
Shariful Haque (1998-1998),1,0,0,0,0,0,0,0.000
Sheikh Salahuddin (1997-1997),6,0,0,0,0,0,0,0.000
Shuvagata Hom (2011-2011),4,0,0,0,0,0,0,0.000
Subashis Roy (2016-2016),1,0,0,0,0,0,0,0.000
Sunzamul Islam (2017-2018),3,0,0,0,0,0,0,0.000
Wahidul Gani (1988-1988),1,0,0,0,0,0,0,0.000
Zahid Razzak (1988-1990),3,0,0,0,0,0,0,0.000
Zakir Hasan (1997-1997),1,0,0,0,0,0,0,0.000
Zakir Hossain (1998-1998),1,0,0,0,0,0,0,0.000
"NJ O'Brien (2006-2018)",96,102,89,13,81,8,5 (5ct 0st),1.062
GC Wilson (2007-2018),92,76,66,10,42,24,4 (4ct 0st),0.826
WTS Porterfield (2006-2018),114,57,57,0,0,57,3 (3ct 0st),0.500
"KJ O'Brien (2006-2018)",121,53,53,0,0,53,3 (3ct 0st),0.438
PR Stirling (2008-2018),93,38,38,0,0,38,3 (3ct 0st),0.408
GH Dockrell (2010-2018),75,32,32,0,0,32,2 (2ct 0st),0.426
DT Johnston (2006-2013),65,25,25,0,0,25,2 (2ct 0st),0.384
EC Joyce (2011-2018),58,21,21,0,0,21,2 (2ct 0st),0.362
AR White (2006-2014),61,21,21,0,0,21,2 (2ct 0st),0.344
JF Mooney (2006-2015),62,19,19,0,0,19,2 (2ct 0st),0.306
AR Cusack (2007-2015),55,18,18,0,0,18,2 (2ct 0st),0.327
SW Poynter (2014-2018),16,17,17,0,14,3,4 (4ct 0st),1.062
AR McBrine (2014-2018),29,16,16,0,0,16,3 (3ct 0st),0.551
WB Rankin (2007-2018),49,15,15,0,0,15,2 (2ct 0st),0.306
A Balbirnie (2010-2018),45,11,11,0,0,11,2 (2ct 0st),0.244
AC Botha (2006-2011),40,11,11,0,0,11,2 (2ct 0st),0.275
TJ Murtagh (2012-2018),41,11,11,0,0,11,1 (1ct 0st),0.268
RD McCann (2010-2010),8,9,9,0,9,0,3 (3ct 0st),1.125
EJG Morgan (2006-2009),22,9,9,0,0,9,3 (3ct 0st),0.409
AD Poynter (2008-2014),18,9,9,0,0,9,2 (2ct 0st),0.500
BJ McCarthy (2016-2018),23,8,8,0,0,8,2 (2ct 0st),0.347
SR Thompson (2013-2017),19,8,8,0,0,8,1 (1ct 0st),0.421
NG Jones (2010-2011),14,7,7,0,0,7,2 (2ct 0st),0.500
JP Bray (2006-2007),15,6,6,0,1,5,2 (2ct 0st),0.400
PKD Chase (2015-2018),21,5,5,0,0,5,2 (2ct 0st),0.238
D Langford-Smith (2006-2008),21,5,5,0,0,5,2 (2ct 0st),0.238
KED Carroll (2007-2007),6,4,4,0,0,4,2 (2ct 0st),0.666
WK McCallan (2006-2009),37,4,4,0,0,4,1 (1ct 0st),0.108
RM West (2008-2009),9,4,4,0,0,4,1 (1ct 0st),0.444
J Anderson (2014-2016),8,3,3,0,0,3,2 (2ct 0st),0.375
MC Sorensen (2013-2016),12,3,3,0,0,3,1 (1ct 0st),0.250
R Strydom (2008-2008),8,3,3,0,0,3,1 (1ct 0st),0.375
PJK Mooney (2006-2007),4,2,2,0,0,2,2 (2ct 0st),0.500
Simi Singh (2017-2018),7,2,2,0,0,2,1 (1ct 0st),0.285
SP Terry (2016-2016),5,2,2,0,0,2,2 (2ct 0st),0.400
CA Young (2014-2017),12,2,2,0,0,2,1 (1ct 0st),0.166
PC Connell (2008-2010),12,1,1,0,0,1,1 (1ct 0st),0.083
MJ Fourie (2007-2008),6,1,1,0,0,1,1 (1ct 0st),0.166
RS Haire (2008-2008),2,1,1,0,0,1,1 (1ct 0st),0.500
DI Joyce (2006-2007),3,1,1,0,0,1,1 (1ct 0st),0.333
GE Kidd (2007-2008),5,1,1,0,0,1,1 (1ct 0st),0.200
J Mulder (2017-2017),4,1,1,0,0,1,1 (1ct 0st),0.250
GJ Thompson (2008-2008),3,1,1,0,0,1,1 (1ct 0st),0.333
A van der Merwe (2010-2011),9,1,1,0,0,1,1 (1ct 0st),0.111
SA Britton (2009-2009),1,0,0,0,0,0,0,0.000
PS Eaglestone (2008-2008),1,0,0,0,0,0,0,0.000
PG Gillespie (2006-2007),5,0,0,0,0,0,0,0.000
JD Hall (2010-2010),3,0,0,0,0,0,0,0.000
GJ McCarter (2014-2014),1,0,0,0,0,0,0,0.000
EJ Richardson (2013-2013),2,0,0,0,0,0,0,0.000
JNK Shannon (2013-2013),1,0,0,0,0,0,0,0.000
RK Whelan (2007-2007),2,0,0,0,0,0,0,0.000
Mohammad Shahzad (2009-2018),68,76,54,22,53,1,5 (4ct 1st),1.117
Mohammad Nabi (2009-2018),96,50,50,0,0,50,3 (3ct 0st),0.520
Najibullah Zadran (2012-2018),44,28,28,0,0,28,3 (3ct 0st),0.636
Afsar Zazai (2014-2017),16,22,20,2,20,0,3 (3ct 0st),1.375
Samiullah Shenwari (2009-2018),77,21,21,0,0,21,2 (2ct 0st),0.272
Nawroz Mangal (2009-2016),49,19,19,0,0,19,2 (2ct 0st),0.387
Asghar Stanikzai (2009-2018),84,16,16,0,0,16,2 (2ct 0st),0.190
Noor Ali Zadran (2009-2017),44,15,15,0,0,15,2 (2ct 0st),0.340
Dawlat Zadran (2011-2018),70,14,14,0,0,14,2 (2ct 0st),0.200
Rashid Khan (2015-2018),42,14,14,0,0,14,3 (3ct 0st),0.333
Rahmat Shah (2013-2018),43,12,12,0,0,12,1 (1ct 0st),0.279
Shafiqullah (2009-2017),23,12,9,3,6,3,2 (1ct 1st),0.521
Amir Hamza (2012-2017),31,10,10,0,0,10,2 (2ct 0st),0.322
Javed Ahmadi (2010-2018),37,10,10,0,0,10,1 (1ct 0st),0.270
Gulbadin Naib (2011-2018),40,8,8,0,0,8,1 (1ct 0st),0.200
Ihsanullah (2017-2018),10,8,8,0,0,8,3 (3ct 0st),0.800
Mirwais Ashraf (2009-2016),45,8,8,0,0,8,2 (2ct 0st),0.177
Karim Sadiq (2009-2016),24,6,6,0,0,6,2 (2ct 0st),0.250
Shabir Noori (2010-2016),10,6,6,0,0,6,2 (2ct 0st),0.600
Hashmatullah Shahidi (2013-2017),17,5,5,0,0,5,1 (1ct 0st),0.294
Shapoor Zadran (2009-2018),43,5,5,0,0,5,1 (1ct 0st),0.116
Hamid Hassan (2009-2016),31,4,4,0,0,4,1 (1ct 0st),0.129
Nasir Jamal (2014-2018),15,4,4,0,0,4,2 (2ct 0st),0.266
Usman Ghani (2014-2017),15,3,3,0,0,3,1 (1ct 0st),0.200
Fareed Ahmad (2014-2017),4,2,2,0,0,2,1 (1ct 0st),0.500
Mohibullah Oryakhel (2013-2013),2,2,2,0,0,2,1 (1ct 0st),1.000
Mujeeb Ur Rahman (2017-2018),15,2,2,0,0,2,1 (1ct 0st),0.133
Naveen-ul-Haq (2016-2016),2,2,2,0,0,2,1 (1ct 0st),1.000
Raees Ahmadzai (2009-2010),5,2,2,0,0,2,1 (1ct 0st),0.400
Sharafuddin Ashraf (2014-2018),14,2,2,0,0,2,1 (1ct 0st),0.142
Yamin Ahmadzai (2015-2016),3,2,2,0,0,2,1 (1ct 0st),0.666
Abdullah Mazari (2010-2010),2,1,1,0,0,1,1 (1ct 0st),0.500
Aftab Alam (2010-2015),12,1,1,0,0,1,1 (1ct 0st),0.083
Izatullah Dawlatzai (2010-2015),5,1,1,0,0,1,1 (1ct 0st),0.200
Noor-ul-Haq (2010-2010),2,1,1,0,0,1,1 (1ct 0st),0.500
Rokhan Barakzai (2015-2015),1,1,1,0,0,1,1 (1ct 0st),1.000
Ahmed Shah (2009-2009),1,0,0,0,0,0,0,0.000
Dawlat Ahmadzai (2009-2010),3,0,0,0,0,0,0,0.000
Hasti Gul (2009-2009),2,0,0,0,0,0,0,0.000
Karim Janat (2017-2017),1,0,0,0,0,0,0,0.000
Khaliq Dad (2009-2010),6,0,0,0,0,0,0,0.000
Najeeb Tarakai (2017-2017),1,0,0,0,0,0,0,0.000
Zakiullah Zaki (2012-2012),1,0,0,0,0,0,0,0.000
